A1BG	alpha-1-B glycoprotein 
A2M	alpha-2-macroglobulin 
AADACL2	arylacetamide deacetylase like 2 
AADAT	aminoadipate aminotransferase 
AAK1	AP2 associated kinase 1 
AANAT	aralkylamine N-acetyltransferase 
AARS1	alanyl-tRNA synthetase 1 
AARS2	alanyl-tRNA synthetase 2, mitochondrial 
AASS	aminoadipate-semialdehyde synthase 
ABAT	4-aminobutyrate aminotransferase 
ABCA1	ATP binding cassette subfamily A member 1 
ABCA3	ATP binding cassette subfamily A member 3 
ABCA5	ATP binding cassette subfamily A member 5 
ABCB1	ATP binding cassette subfamily B member 1 
ABCB10	ATP binding cassette subfamily B member 10 
ABCB11	ATP binding cassette subfamily B member 11 
ABCB4	ATP binding cassette subfamily B member 4 
ABCB5	ATP binding cassette subfamily B member 5 
ABCB6	ATP binding cassette subfamily B member 6 (Langereis blood group) 
ABCB8	ATP binding cassette subfamily B member 8 
ABCB9	ATP binding cassette subfamily B member 9 
ABCC1	ATP binding cassette subfamily C member 1 
ABCC10	ATP binding cassette subfamily C member 10 
ABCC11	ATP binding cassette subfamily C member 11 
ABCC2	ATP binding cassette subfamily C member 2 
ABCC3	ATP binding cassette subfamily C member 3 
ABCC4	ATP binding cassette subfamily C member 4 
ABCC5	ATP binding cassette subfamily C member 5 
ABCC6	ATP binding cassette subfamily C member 6 
ABCC8	ATP binding cassette subfamily C member 8 
ABCC9	ATP binding cassette subfamily C member 9 
ABCG1	ATP binding cassette subfamily G member 1 
ABCG2	ATP binding cassette subfamily G member 2 (Junior blood group) 
ABCG5	ATP binding cassette subfamily G member 5 
ABCG8	ATP binding cassette subfamily G member 8 
ABL1	ABL proto-oncogene 1, non-receptor tyrosine kinase 
ABL2	ABL proto-oncogene 2, non-receptor tyrosine kinase 
ABO	ABO, alpha 1-3-N-acetylgalactosaminyltransferase and alpha 1-3-galactosyltransferase 
ACAA1	acetyl-CoA acyltransferase 1 
ACACA	acetyl-CoA carboxylase alpha 
ACACB	acetyl-CoA carboxylase beta 
ACAD8	acyl-CoA dehydrogenase family member 8 
ACADM	acyl-CoA dehydrogenase medium chain 
ACADS	acyl-CoA dehydrogenase short chain 
ACADSB	acyl-CoA dehydrogenase short/branched chain 
ACAN	aggrecan 
ACAT1	acetyl-CoA acetyltransferase 1 
ACAT2	acetyl-CoA acetyltransferase 2 
ACCS	1-aminocyclopropane-1-carboxylate synthase homolog (inactive) 
ACE	angiotensin I converting enzyme 
ACE2	angiotensin I converting enzyme 2 
ACHE	acetylcholinesterase (Cartwright blood group) 
ACO1	aconitase 1 
ACO2	aconitase 2 
ACOT13	acyl-CoA thioesterase 13 
ACOX1	acyl-CoA oxidase 1 
ACP1	acid phosphatase 1 
ACP5	acid phosphatase 5, tartrate resistant 
ACPP	acid phosphatase, prostate 
ACSBG1	acyl-CoA synthetase bubblegum family member 1 
ACSL1	acyl-CoA synthetase long chain family member 1 
ACSL3	acyl-CoA synthetase long chain family member 3 
ACSL4	acyl-CoA synthetase long chain family member 4 
ACSS1	acyl-CoA synthetase short chain family member 1 
ACSS2	acyl-CoA synthetase short chain family member 2 
ACTA1	actin alpha 1, skeletal muscle 
ACTA2	actin alpha 2, smooth muscle 
ACTB	actin beta 
ACTG1	actin gamma 1 
ACTN1	actinin alpha 1 
ACTR2	actin related protein 2 
ACTR3	actin related protein 3 
ACVR1	activin A receptor type 1 
ACVR1B	activin A receptor type 1B 
ACVR2A	activin A receptor type 2A 
ACVRL1	activin A receptor like type 1 
ACY1	aminoacylase 1 
ACY3	aminoacylase 3 
ACYP2	acylphosphatase 2 
ADA	adenosine deaminase 
ADAM10	ADAM metallopeptidase domain 10 
ADAM17	ADAM metallopeptidase domain 17 
ADAM28	ADAM metallopeptidase domain 28 
ADAM9	ADAM metallopeptidase domain 9 
ADAMTS1	ADAM metallopeptidase with thrombospondin type 1 motif 1 
ADAMTS13	ADAM metallopeptidase with thrombospondin type 1 motif 13 
ADAMTS4	ADAM metallopeptidase with thrombospondin type 1 motif 4 
ADAMTS5	ADAM metallopeptidase with thrombospondin type 1 motif 5 
ADCY1	adenylate cyclase 1 
ADCY2	adenylate cyclase 2 
ADCY5	adenylate cyclase 5 
ADCY9	adenylate cyclase 9 
ADCYAP1	adenylate cyclase activating polypeptide 1 
ADD1	adducin 1 
ADGRD1	adhesion G protein-coupled receptor D1 
ADGRF1	adhesion G protein-coupled receptor F1 
ADGRL3	adhesion G protein-coupled receptor L3 
ADH1A	alcohol dehydrogenase 1A (class I), alpha polypeptide 
ADH1B	alcohol dehydrogenase 1B (class I), beta polypeptide 
ADH1C	alcohol dehydrogenase 1C (class I), gamma polypeptide 
ADH4	alcohol dehydrogenase 4 (class II), pi polypeptide 
ADH5	alcohol dehydrogenase 5 (class III), chi polypeptide 
ADH6	alcohol dehydrogenase 6 (class V) 
ADH7	alcohol dehydrogenase 7 (class IV), mu or sigma polypeptide 
ADHFE1	alcohol dehydrogenase iron containing 1 
ADI1	acireductone dioxygenase 1 
ADIPOQ	adiponectin, C1Q and collagen domain containing 
ADK	adenosine kinase 
ADM	adrenomedullin 
ADORA1	adenosine A1 receptor 
ADORA2A	adenosine A2a receptor 
ADORA2A-AS1	ADORA2A antisense RNA 1 
ADORA2B	adenosine A2b receptor 
ADORA3	adenosine A3 receptor 
ADRA1A	adrenoceptor alpha 1A 
ADRA1B	adrenoceptor alpha 1B 
ADRA1D	adrenoceptor alpha 1D 
ADRA2A	adrenoceptor alpha 2A 
ADRA2B	adrenoceptor alpha 2B 
ADRA2C	adrenoceptor alpha 2C 
ADRB1	adrenoceptor beta 1 
ADRB2	adrenoceptor beta 2 
ADRB3	adrenoceptor beta 3 
ADSS1	adenylosuccinate synthase 1 
ADSS2	adenylosuccinate synthase 2 
AFDN	afadin, adherens junction formation factor 
AFG3L2	AFG3 like matrix AAA peptidase subunit 2 
AFM	afamin 
AGBL4	ATP/GTP binding protein like 4 
AGT	angiotensinogen 
AGTR1	angiotensin II receptor type 1 
AGTR2	angiotensin II receptor type 2 
AGXT	alanine--glyoxylate and serine--pyruvate aminotransferase 
AGXT2	alanine--glyoxylate aminotransferase 2 
AHCY	adenosylhomocysteinase 
AHR	aryl hydrocarbon receptor 
AHSG	alpha 2-HS glycoprotein 
AHSP	alpha hemoglobin stabilizing protein 
AIFM1	apoptosis inducing factor mitochondria associated 1 
AK1	adenylate kinase 1 
AK2	adenylate kinase 2 
AK4	adenylate kinase 4 
AK8	adenylate kinase 8 
AKR1A1	aldo-keto reductase family 1 member A1 
AKR1B1	aldo-keto reductase family 1 member B 
AKR1B10	aldo-keto reductase family 1 member B10 
AKR1B15	aldo-keto reductase family 1 member B15 
AKR1C1	aldo-keto reductase family 1 member C1 
AKR1C2	aldo-keto reductase family 1 member C2 
AKR1C3	aldo-keto reductase family 1 member C3 
AKR1C4	aldo-keto reductase family 1 member C4 
AKR1D1	aldo-keto reductase family 1 member D1 
AKR1E2	aldo-keto reductase family 1 member E2 
AKT1	AKT serine/threonine kinase 1 
AKT2	AKT serine/threonine kinase 2 
ALAD	aminolevulinate dehydratase 
ALAS1	5'-aminolevulinate synthase 1 
ALAS2	5'-aminolevulinate synthase 2 
ALB	albumin 
ALDH18A1	aldehyde dehydrogenase 18 family member A1 
ALDH1A1	aldehyde dehydrogenase 1 family member A1 
ALDH1A2	aldehyde dehydrogenase 1 family member A2 
ALDH1A3	aldehyde dehydrogenase 1 family member A3 
ALDH1B1	aldehyde dehydrogenase 1 family member B1 
ALDH1L1	aldehyde dehydrogenase 1 family member L1 
ALDH2	aldehyde dehydrogenase 2 family member 
ALDH3A1	aldehyde dehydrogenase 3 family member A1 
ALDH3A2	aldehyde dehydrogenase 3 family member A2 
ALDH3B1	aldehyde dehydrogenase 3 family member B1 
ALDH3B2	aldehyde dehydrogenase 3 family member B2 
ALDH4A1	aldehyde dehydrogenase 4 family member A1 
ALDH5A1	aldehyde dehydrogenase 5 family member A1 
ALDH6A1	aldehyde dehydrogenase 6 family member A1 
ALDH7A1	aldehyde dehydrogenase 7 family member A1 
ALDH9A1	aldehyde dehydrogenase 9 family member A1 
ALDOA	aldolase, fructose-bisphosphate A 
ALDOB	aldolase, fructose-bisphosphate B 
ALG10	ALG10 alpha-1,2-glucosyltransferase 
ALK	ALK receptor tyrosine kinase 
ALKBH2	alkB homolog 2, alpha-ketoglutarate dependent dioxygenase 
ALKBH3	alkB homolog 3, alpha-ketoglutaratedependent dioxygenase 
ALOX12	arachidonate 12-lipoxygenase, 12S type 
ALOX15	arachidonate 15-lipoxygenase 
ALOX5	arachidonate 5-lipoxygenase 
ALOX5AP	arachidonate 5-lipoxygenase activating protein 
ALPG	alkaline phosphatase, germ cell 
ALPL	alkaline phosphatase, biomineralization associated 
ALPP	alkaline phosphatase, placental 
AMACR	alpha-methylacyl-CoA racemase 
AMD1	adenosylmethionine decarboxylase 1 
AMHR2	anti-Mullerian hormone receptor type 2 
AMN	amnion associated transmembrane protein 
AMPD1	adenosine monophosphate deaminase 1 
AMT	aminomethyltransferase 
AMY1A	amylase alpha 1A 
AMY2A	amylase alpha 2A 
AMY2B	amylase alpha 2B 
ANG	angiogenin 
ANKFN1	ankyrin repeat and fibronectin type III domain containing 1 
ANKK1	ankyrin repeat and kinase domain containing 1 
ANKS1B	ankyrin repeat and sterile alpha motif domain containing 1B 
ANO1	anoctamin 1 
ANO2	anoctamin 2 
ANPEP	alanyl aminopeptidase, membrane 
ANTXR1	ANTXR cell adhesion molecule 1 
ANTXR2	ANTXR cell adhesion molecule 2 
ANXA1	annexin A1 
ANXA2	annexin A2 
ANXA3	annexin A3 
ANXA4	annexin A4 
ANXA5	annexin A5 
AOC1	amine oxidase copper containing 1 
AOC3	amine oxidase copper containing 3 
AOX1	aldehyde oxidase 1 
APAF1	apoptotic peptidase activating factor 1 
APCS	amyloid P component, serum 
APEX1	apurinic/apyrimidinic endodeoxyribonuclease 1 
APH1A	aph-1 homolog A, gamma-secretase subunit 
APLF	aprataxin and PNKP like factor 
APLP1	amyloid beta precursor like protein 1 
APLP2	amyloid beta precursor like protein 2 
APOA1	apolipoprotein A1 
APOA2	apolipoprotein A2 
APOA4	apolipoprotein A4 
APOA5	apolipoprotein A5 
APOB	apolipoprotein B 
APOBR	apolipoprotein B receptor 
APOC1	apolipoprotein C1 
APOC2	apolipoprotein C2 
APOC3	apolipoprotein C3 
APOD	apolipoprotein D 
APOE	apolipoprotein E 
APOH	apolipoprotein H 
APOL1	apolipoprotein L1 
APOM	apolipoprotein M 
APP	amyloid beta precursor protein 
APRT	adenine phosphoribosyltransferase 
AQP1	aquaporin 1 (Colton blood group) 
AQP2	aquaporin 2 
AQP3	aquaporin 3 (Gill blood group) 
AR	androgen receptor 
ARAF	A-Raf proto-oncogene, serine/threonine kinase 
ARAP2	ArfGAP with RhoGAP domain, ankyrin repeat and PH domain 2 
AREG	amphiregulin 
ARF1	ADP ribosylation factor 1 
ARF4	ADP ribosylation factor 4 
ARF6	ADP ribosylation factor 6 
ARG1	arginase 1 
ARG2	arginase 2 
ARHGAP12	Rho GTPase activating protein 12 
ARHGEF28	Rho guanine nucleotide exchange factor 28 
ARID5B	AT-rich interaction domain 5B 
ARL1	ADP ribosylation factor like GTPase 1 
ARL2	ADP ribosylation factor like GTPase 2 
ARL3	ADP ribosylation factor like GTPase 3 
ARL5A	ADP ribosylation factor like GTPase 5A 
ARL5B	ADP ribosylation factor like GTPase 5B 
ARMS2	age-related maculopathy susceptibility 2 
ARPC1B	actin related protein 2/3 complex subunit 1B 
ARPC2	actin related protein 2/3 complex subunit 2 
ARPC3	actin related protein 2/3 complex subunit 3 
ARPC4	actin related protein 2/3 complex subunit 4 
ARPC5	actin related protein 2/3 complex subunit 5 
ARRB2	arrestin beta 2 
ARSA	arylsulfatase A 
ARSB	arylsulfatase B 
ART1	ADP-ribosyltransferase 1 
AS3MT	arsenite methyltransferase 
ASGR2	asialoglycoprotein receptor 2 
ASIC1	acid sensing ion channel subunit 1 
ASIC2	acid sensing ion channel subunit 2 
ASIC3	acid sensing ion channel subunit 3 
ASL	argininosuccinate lyase 
ASMT	acetylserotonin O-methyltransferase 
ASNS	asparagine synthetase (glutamine-hydrolyzing) 
ASPA	aspartoacylase 
ASPG	asparaginase 
ASPH	aspartate beta-hydroxylase 
ASRGL1	asparaginase and isoaspartyl peptidase 1 
ASS1	argininosuccinate synthase 1 
ATF1	activating transcription factor 1 
ATF2	activating transcription factor 2 
ATF3	activating transcription factor 3 
ATF4	activating transcription factor 4 
ATF5	activating transcription factor 5 
ATF6	activating transcription factor 6 
ATF7	activating transcription factor 7 
ATG16L1	autophagy related 16 like 1 
ATG5	autophagy related 5 
ATIC	5-aminoimidazole-4-carboxamide ribonucleotide formyltransferase/IMP cyclohydrolase 
ATM	ATM serine/threonine kinase 
ATOX1	antioxidant 1 copper chaperone 
ATP10A	ATPase phospholipid transporting 10A (putative) 
ATP1A1	ATPase Na+/K+ transporting subunit alpha 1 
ATP1A2	ATPase Na+/K+ transporting subunit alpha 2 
ATP1A3	ATPase Na+/K+ transporting subunit alpha 3 
ATP1A4	ATPase Na+/K+ transporting subunit alpha 4 
ATP1B1	ATPase Na+/K+ transporting subunit beta 1 
ATP1B2	ATPase Na+/K+ transporting subunit beta 2 
ATP1B3	ATPase Na+/K+ transporting subunit beta 3 
ATP2A1	ATPase sarcoplasmic/endoplasmic reticulum Ca2+ transporting 1 
ATP2A2	ATPase sarcoplasmic/endoplasmic reticulum Ca2+ transporting 2 
ATP2B1	ATPase plasma membrane Ca2+ transporting 1 
ATP2C1	ATPase secretory pathway Ca2+ transporting 1 
ATP4A	ATPase H+/K+ transporting subunit alpha 
ATP4B	ATPase H+/K+ transporting subunit beta 
ATP5F1A	ATP synthase F1 subunit alpha 
ATP5F1B	ATP synthase F1 subunit beta 
ATP5F1C	ATP synthase F1 subunit gamma 
ATP5F1D	ATP synthase F1 subunit delta 
ATP5F1E	ATP synthase F1 subunit epsilon 
ATP5ME	ATP synthase membrane subunit e 
ATP5MG	ATP synthase membrane subunit g 
ATP5PO	ATP synthase peripheral stalk subunit OSCP 
ATP6V1A	ATPase H+ transporting V1 subunit A 
ATP6V1B2	ATPase H+ transporting V1 subunit B2 
ATP6V1C1	ATPase H+ transporting V1 subunit C1 
ATP7A	ATPase copper transporting alpha 
ATP7B	ATPase copper transporting beta 
ATP8A1	ATPase phospholipid transporting 8A1 
AURKA	aurora kinase A 
AURKB	aurora kinase B 
AURKC	aurora kinase C 
AVPR1A	arginine vasopressin receptor 1A 
AVPR1B	arginine vasopressin receptor 1B 
AVPR2	arginine vasopressin receptor 2 
AXIN1	axin 1 
AXIN2	axin 2 
AXL	AXL receptor tyrosine kinase 
AZGP1	alpha-2-glycoprotein 1, zinc-binding 
AZIN2	antizyme inhibitor 2 
B2M	beta-2-microglobulin 
B3GAT1	beta-1,3-glucuronyltransferase 1 
B3GAT3	beta-1,3-glucuronyltransferase 3 
B4GALT1	beta-1,4-galactosyltransferase 1 
B4GALT2	beta-1,4-galactosyltransferase 2 
B4GALT3	beta-1,4-galactosyltransferase 3 
B4GALT4	beta-1,4-galactosyltransferase 4 
BAAT	bile acid-CoA:amino acid N-acyltransferase 
BACE1	beta-secretase 1 
BACH1	BTB domain and CNC homolog 1 
BAD	BCL2 associated agonist of cell death 
BAG1	BCL2 associated athanogene 1 
BAG6	BCL2 associated athanogene 6 
BARD1	BRCA1 associated RING domain 1 
BBOX1	gamma-butyrobetaine hydroxylase 1 
BCAT1	branched chain amino acid transaminase 1 
BCAT2	branched chain amino acid transaminase 2 
BCHE	butyrylcholinesterase 
BCKDK	branched chain keto acid dehydrogenase kinase 
BCL2	BCL2 apoptosis regulator 
BCL2L1	BCL2 like 1 
BCL2L11	BCL2 like 11 
BCL2L2	BCL2 like 2 
BCO1	beta-carotene oxygenase 1 
BCR	BCR activator of RhoGEF and GTPase 
BDH1	3-hydroxybutyrate dehydrogenase 1 
BDKRB1	bradykinin receptor B1 
BDKRB2	bradykinin receptor B2 
BDNF	brain derived neurotrophic factor 
BDNF-AS	BDNF antisense RNA 
BECN1	beclin 1 
BGLAP	bone gamma-carboxyglutamate protein 
BHMT	betaine--homocysteine S-methyltransferase 
BHMT2	betaine--homocysteine S-methyltransferase 2 
BIRC5	baculoviral IAP repeat containing 5 
BLK	BLK proto-oncogene, Src family tyrosine kinase 
BLMH	bleomycin hydrolase 
BLVRA	biliverdin reductase A 
BLVRB	biliverdin reductase B 
BMP2K	BMP2 inducible kinase 
BMP4	bone morphogenetic protein 4 
BMP5	bone morphogenetic protein 5 
BMP7	bone morphogenetic protein 7 
BMPR1A	bone morphogenetic protein receptor type 1A 
BMPR1B	bone morphogenetic protein receptor type 1B 
BMPR2	bone morphogenetic protein receptor type 2 
BMX	BMX non-receptor tyrosine kinase 
BPHL	biphenyl hydrolase like 
BPI	bactericidal permeability increasing protein 
BRAF	B-Raf proto-oncogene, serine/threonine kinase 
BRCA1	BRCA1 DNA repair associated 
BRCA2	BRCA2 DNA repair associated 
BRCC3	BRCA1/BRCA2-containing complex subunit 3 
BST1	bone marrow stromal cell antigen 1 
BTK	Bruton tyrosine kinase 
C11orf65	chromosome 11 open reading frame 65 
C1QA	complement C1q A chain 
C1QB	complement C1q B chain 
C1QBP	complement C1q binding protein 
C1QC	complement C1q C chain 
C1R	complement C1r 
C1S	complement C1s 
C3	complement C3 
C4A	complement C4A (Rodgers blood group) 
C4B	complement C4B (Chido blood group) 
C4BPA	complement component 4 binding protein alpha 
C4BPB	complement component 4 binding protein beta 
C5	complement C5 
C6	complement C6 
C8A	complement C8 alpha chain 
C8B	complement C8 beta chain 
C8G	complement C8 gamma chain 
C8orf34	chromosome 8 open reading frame 34 
C9	complement C9 
C9orf72	C9orf72-SMCR8 complex subunit 
CA1	carbonic anhydrase 1 
CA10	carbonic anhydrase 10 
CA11	carbonic anhydrase 11 
CA12	carbonic anhydrase 12 
CA13	carbonic anhydrase 13 
CA14	carbonic anhydrase 14 
CA2	carbonic anhydrase 2 
CA3	carbonic anhydrase 3 
CA4	carbonic anhydrase 4 
CA5A	carbonic anhydrase 5A 
CA5B	carbonic anhydrase 5B 
CA6	carbonic anhydrase 6 
CA7	carbonic anhydrase 7 
CA8	carbonic anhydrase 8 
CA9	carbonic anhydrase 9 
CACNA1A	calcium voltage-gated channel subunit alpha1 A 
CACNA1B	calcium voltage-gated channel subunit alpha1 B 
CACNA1C	calcium voltage-gated channel subunit alpha1 C 
CACNA1D	calcium voltage-gated channel subunit alpha1 D 
CACNA1E	calcium voltage-gated channel subunit alpha1 E 
CACNA1F	calcium voltage-gated channel subunit alpha1 F 
CACNA1G	calcium voltage-gated channel subunit alpha1 G 
CACNA1H	calcium voltage-gated channel subunit alpha1 H 
CACNA1I	calcium voltage-gated channel subunit alpha1 I 
CACNA1S	calcium voltage-gated channel subunit alpha1 S 
CACNA2D1	calcium voltage-gated channel auxiliary subunit alpha2delta 1 
CACNA2D2	calcium voltage-gated channel auxiliary subunit alpha2delta 2 
CACNA2D3	calcium voltage-gated channel auxiliary subunit alpha2delta 3 
CACNA2D4	calcium voltage-gated channel auxiliary subunit alpha2delta 4 
CACNB1	calcium voltage-gated channel auxiliary subunit beta 1 
CACNB2	calcium voltage-gated channel auxiliary subunit beta 2 
CACNB3	calcium voltage-gated channel auxiliary subunit beta 3 
CACNB4	calcium voltage-gated channel auxiliary subunit beta 4 
CACNG1	calcium voltage-gated channel auxiliary subunit gamma 1 
CACNG2	calcium voltage-gated channel auxiliary subunit gamma 2 
CACNG3	calcium voltage-gated channel auxiliary subunit gamma 3 
CACNG4	calcium voltage-gated channel auxiliary subunit gamma 4 
CACNG5	calcium voltage-gated channel auxiliary subunit gamma 5 
CACNG6	calcium voltage-gated channel auxiliary subunit gamma 6 
CACNG7	calcium voltage-gated channel auxiliary subunit gamma 7 
CACNG8	calcium voltage-gated channel auxiliary subunit gamma 8 
CAD	carbamoyl-phosphate synthetase 2, aspartate transcarbamylase, and dihydroorotase 
CADPS	calcium dependent secretion activator 
CADPS2	calcium dependent secretion activator 2 
CALB1	calbindin 1 
CALB2	calbindin 2 
CALCA	calcitonin related polypeptide alpha 
CALCB	calcitonin related polypeptide beta 
CALCR	calcitonin receptor 
CALCRL	calcitonin receptor like receptor 
CALM1	calmodulin 1 
CALM2	calmodulin 2 
CALM3	calmodulin 3 
CALR	calreticulin 
CALR3	calreticulin 3 
CALU	calumenin 
CALY	calcyon neuron specific vesicular protein 
CAMK1	calcium/calmodulin dependent protein kinase I 
CAMK1D	calcium/calmodulin dependent protein kinase ID 
CAMK1G	calcium/calmodulin dependent protein kinase IG 
CAMK2A	calcium/calmodulin dependent protein kinase II alpha 
CAMK2B	calcium/calmodulin dependent protein kinase II beta 
CAMK2D	calcium/calmodulin dependent protein kinase II delta 
CAMK2G	calcium/calmodulin dependent protein kinase II gamma 
CAMK4	calcium/calmodulin dependent protein kinase IV 
CAMKK1	calcium/calmodulin dependent protein kinase kinase 1 
CAMKK2	calcium/calmodulin dependent protein kinase kinase 2 
CAMLG	calcium modulating ligand 
CAMP	cathelicidin antimicrobial peptide 
CANT1	calcium activated nucleotidase 1 
CANX	calnexin 
CAPG	capping actin protein, gelsolin like 
CAPN1	calpain 1 
CAPN10	calpain 10 
CAPN3	calpain 3 
CAPNS1	calpain small subunit 1 
CAPS	calcyphosine 
CARS1	cysteinyl-tRNA synthetase 1 
CARS2	cysteinyl-tRNA synthetase 2, mitochondrial 
CARTPT	CART prepropeptide 
CASK	calcium/calmodulin dependent serine protein kinase 
CASP1	caspase 1 
CASP3	caspase 3 
CASP7	caspase 7 
CASP8	caspase 8 
CASQ1	calsequestrin 1 
CASQ2	calsequestrin 2 
CASR	calcium sensing receptor 
CAST	calpastatin 
CAT	catalase 
CATSPER1	cation channel sperm associated 1 
CBLIF	cobalamin binding intrinsic factor 
CBR1	carbonyl reductase 1 
CBR3	carbonyl reductase 3 
CBS	cystathionine beta-synthase 
CBX5	chromobox 5 
CCHCR1	coiled-coil alpha-helical rod protein 1 
CCKAR	cholecystokinin A receptor 
CCKBR	cholecystokinin B receptor 
CCL11	C-C motif chemokine ligand 11 
CCL2	C-C motif chemokine ligand 2 
CCL3	C-C motif chemokine ligand 3 
CCL5	C-C motif chemokine ligand 5 
CCL8	C-C motif chemokine ligand 8 
CCN3	cellular communication network factor 3 
CCNA2	cyclin A2 
CCND1	cyclin D1 
CCNK	cyclin K 
CCR2	C-C motif chemokine receptor 2 
CCR4	C-C motif chemokine receptor 4 
CCR5	C-C motif chemokine receptor 5 (gene/pseudogene) 
CCR9	C-C motif chemokine receptor 9 
CCS	copper chaperone for superoxide dismutase 
CCT3	chaperonin containing TCP1 subunit 3 
CD14	CD14 molecule 
CD163	CD163 molecule 
CD19	CD19 molecule 
CD1A	CD1a molecule 
CD1D	CD1d molecule 
CD2	CD2 molecule 
CD22	CD22 molecule 
CD247	CD247 molecule 
CD274	CD274 molecule 
CD33	CD33 molecule 
CD38	CD38 molecule 
CD3D	CD3d molecule 
CD3E	CD3e molecule 
CD3EAP	CD3e molecule associated protein 
CD3G	CD3g molecule 
CD4	CD4 molecule 
CD40	CD40 molecule 
CD40LG	CD40 ligand 
CD44	CD44 molecule (Indian blood group) 
CD52	CD52 molecule 
CD55	CD55 molecule (Cromer blood group) 
CD58	CD58 molecule 
CD69	CD69 molecule 
CD79B	CD79b molecule 
CD80	CD80 molecule 
CD84	CD84 molecule 
CD86	CD86 molecule 
CD9	CD9 molecule 
CDA	cytidine deaminase 
CDC25B	cell division cycle 25B 
CDC42	cell division cycle 42 
CDC42BPG	CDC42 binding protein kinase gamma 
CDC5L	cell division cycle 5 like 
CDH11	cadherin 11 
CDH2	cadherin 2 
CDH23	cadherin related 23 
CDH5	cadherin 5 
CDIPT	CDP-diacylglycerol--inositol 3-phosphatidyltransferase 
CDK1	cyclin dependent kinase 1 
CDK15	cyclin dependent kinase 15 
CDK16	cyclin dependent kinase 16 
CDK17	cyclin dependent kinase 17 
CDK2	cyclin dependent kinase 2 
CDK4	cyclin dependent kinase 4 
CDK5	cyclin dependent kinase 5 
CDK5R1	cyclin dependent kinase 5 regulatory subunit 1 
CDK6	cyclin dependent kinase 6 
CDK7	cyclin dependent kinase 7 
CDK8	cyclin dependent kinase 8 
CDK9	cyclin dependent kinase 9 
CDKAL1	CDK5 regulatory subunit associated protein 1 like 1 
CDKL1	cyclin dependent kinase like 1 
CDKL2	cyclin dependent kinase like 2 
CDKN1A	cyclin dependent kinase inhibitor 1A 
CDKN2B-AS1	CDKN2B antisense RNA 1 
CDO1	cysteine dioxygenase type 1 
CEACAM1	CEA cell adhesion molecule 1 
CEACAM5	CEA cell adhesion molecule 5 
CEBPB	CCAAT enhancer binding protein beta 
CEL	carboxyl ester lipase 
CELA1	chymotrypsin like elastase 1 
CELA2A	chymotrypsin like elastase 2A 
CELF4	CUGBP Elav-like family member 4 
CELSR2	cadherin EGF LAG seven-pass G-type receptor 2 
CENPE	centromere protein E 
CEP68	centrosomal protein 68 
CEP72	centrosomal protein 72 
CEPT1	choline/ethanolamine phosphotransferase 1 
CERKL	ceramide kinase like 
CERS6	ceramide synthase 6 
CES1	carboxylesterase 1 
CES1P1	carboxylesterase 1 pseudogene 1 
CES2	carboxylesterase 2 
CETP	cholesteryl ester transfer protein 
CFAP44	cilia and flagella associated protein 44 
CFB	complement factor B 
CFD	complement factor D 
CFH	complement factor H 
CFHR4	complement factor H related 4 
CFI	complement factor I 
CFL1	cofilin 1 
CFTR	CF transmembrane conductance regulator 
CHAT	choline O-acetyltransferase 
CHD1	chromodomain helicase DNA binding protein 1 
CHDH	choline dehydrogenase 
CHEK1	checkpoint kinase 1 
CHEK2	checkpoint kinase 2 
CHIA	chitinase acidic 
CHIT1	chitinase 1 
CHKA	choline kinase alpha 
CHKB	choline kinase beta 
CHP1	calcineurin like EF-hand protein 1 
CHRFAM7A	CHRNA7 (exons 5-10) and FAM7A (exons A-E) fusion 
CHRM1	cholinergic receptor muscarinic 1 
CHRM2	cholinergic receptor muscarinic 2 
CHRM3	cholinergic receptor muscarinic 3 
CHRM4	cholinergic receptor muscarinic 4 
CHRM5	cholinergic receptor muscarinic 5 
CHRNA1	cholinergic receptor nicotinic alpha 1 subunit 
CHRNA10	cholinergic receptor nicotinic alpha 10 subunit 
CHRNA2	cholinergic receptor nicotinic alpha 2 subunit 
CHRNA3	cholinergic receptor nicotinic alpha 3 subunit 
CHRNA4	cholinergic receptor nicotinic alpha 4 subunit 
CHRNA5	cholinergic receptor nicotinic alpha 5 subunit 
CHRNA6	cholinergic receptor nicotinic alpha 6 subunit 
CHRNA7	cholinergic receptor nicotinic alpha 7 subunit 
CHRNA9	cholinergic receptor nicotinic alpha 9 subunit 
CHRNB1	cholinergic receptor nicotinic beta 1 subunit 
CHRNB2	cholinergic receptor nicotinic beta 2 subunit 
CHRNB3	cholinergic receptor nicotinic beta 3 subunit 
CHRNB4	cholinergic receptor nicotinic beta 4 subunit 
CHRND	cholinergic receptor nicotinic delta subunit 
CHRNE	cholinergic receptor nicotinic epsilon subunit 
CHRNG	cholinergic receptor nicotinic gamma subunit 
CHST1	carbohydrate sulfotransferase 1 
CHST10	carbohydrate sulfotransferase 10 
CHST11	carbohydrate sulfotransferase 11 
CHST13	carbohydrate sulfotransferase 13 
CHST2	carbohydrate sulfotransferase 2 
CHST3	carbohydrate sulfotransferase 3 
CHST4	carbohydrate sulfotransferase 4 
CHST5	carbohydrate sulfotransferase 5 
CHST6	carbohydrate sulfotransferase 6 
CHST9	carbohydrate sulfotransferase 9 
CHUK	component of inhibitor of nuclear factor kappa B kinase complex 
CHURC1	churchill domain containing 1 
CIB1	calcium and integrin binding 1 
CIB2	calcium and integrin binding family member 2 
CIT	citron rho-interacting serine/threonine kinase 
CKB	creatine kinase B 
CKM	creatine kinase, M-type 
CKMT1A	creatine kinase, mitochondrial 1A 
CKMT2	creatine kinase, mitochondrial 2 
CKS1B	CDC28 protein kinase regulatory subunit 1B 
CLASP1	cytoplasmic linker associated protein 1 
CLC	Charcot-Leyden crystal galectin 
CLCN2	chloride voltage-gated channel 2 
CLCN6	chloride voltage-gated channel 6 
CLCNKA	chloride voltage-gated channel Ka 
CLEC14A	C-type lectin domain containing 14A 
CLEC3B	C-type lectin domain family 3 member B 
CLEC4E	C-type lectin domain family 4 member E 
CLIC1	chloride intracellular channel 1 
CLK1	CDC like kinase 1 
CLK2	CDC like kinase 2 
CLK3	CDC like kinase 3 
CLK4	CDC like kinase 4 
CLNK	cytokine dependent hematopoietic cell linker 
CLOCK	clock circadian regulator 
CLPP	caseinolytic mitochondrial matrix peptidase proteolytic subunit 
CLPS	colipase 
CLU	clusterin 
CMA1	chymase 1 
CMAS	cytidine monophosphate N-acetylneuraminic acid synthetase 
CMPK1	cytidine/uridine monophosphate kinase 1 
CMTM8	CKLF like MARVEL transmembrane domain containing 8 
CMTR1	cap methyltransferase 1 
CNGA1	cyclic nucleotide gated channel subunit alpha 1 
CNNM2	cyclin and CBS domain divalent metal cation transport mediator 2 
CNPY4	canopy FGF signaling regulator 4 
CNR1	cannabinoid receptor 1 
CNR2	cannabinoid receptor 2 
COL1A1	collagen type I alpha 1 chain 
COL1A2	collagen type I alpha 2 chain 
COL22A1	collagen type XXII alpha 1 chain 
COL26A1	collagen type XXVI alpha 1 chain 
COL2A1	collagen type II alpha 1 chain 
COL3A1	collagen type III alpha 1 chain 
COL4A4	collagen type IV alpha 4 chain 
COMP	cartilage oligomeric matrix protein 
COMT	catechol-O-methyltransferase 
COMTD1	catechol-O-methyltransferase domain containing 1 
COPG1	coatomer protein complex subunit gamma 1 
COQ2	coenzyme Q2, polyprenyltransferase 
COQ8A	coenzyme Q8A 
COQ8B	coenzyme Q8B 
CORO7	coronin 7 
COX17	cytochrome c oxidase copper chaperone COX17 
COX4I1	cytochrome c oxidase subunit 4I1 
COX5A	cytochrome c oxidase subunit 5A 
COX5B	cytochrome c oxidase subunit 5B 
COX6A2	cytochrome c oxidase subunit 6A2 
COX6B1	cytochrome c oxidase subunit 6B1 
COX6C	cytochrome c oxidase subunit 6C 
COX7A1	cytochrome c oxidase subunit 7A1 
COX7B	cytochrome c oxidase subunit 7B 
COX7C	cytochrome c oxidase subunit 7C 
COX8A	cytochrome c oxidase subunit 8A 
CP	ceruloplasmin 
CPA1	carboxypeptidase A1 
CPA2	carboxypeptidase A2 
CPA6	carboxypeptidase A6 
CPB1	carboxypeptidase B1 
CPB2	carboxypeptidase B2 
CPD	carboxypeptidase D 
CPE	carboxypeptidase E 
CPN1	carboxypeptidase N subunit 1 
CPN2	carboxypeptidase N subunit 2 
CPNE1	copine 1 
CPOX	coproporphyrinogen oxidase 
CPQ	carboxypeptidase Q 
CPS1	carbamoyl-phosphate synthase 1 
CPT1A	carnitine palmitoyltransferase 1A 
CPT2	carnitine palmitoyltransferase 2 
CR1	complement C3b/C4b receptor 1 (Knops blood group) 
CRABP1	cellular retinoic acid binding protein 1 
CRABP2	cellular retinoic acid binding protein 2 
CRAT	carnitine O-acetyltransferase 
CRBN	cereblon 
CREB1	cAMP responsive element binding protein 1 
CREBBP	CREB binding protein 
CRH	corticotropin releasing hormone 
CRHBP	corticotropin releasing hormone binding protein 
CRHR1	corticotropin releasing hormone receptor 1 
CRHR2	corticotropin releasing hormone receptor 2 
CROT	carnitine O-octanoyltransferase 
CRP	C-reactive protein 
CRTC2	CREB regulated transcription coactivator 2 
CRY1	cryptochrome circadian regulator 1 
CRYM	crystallin mu 
CRYZ	crystallin zeta 
CS	citrate synthase 
CSAD	cysteine sulfinic acid decarboxylase 
CSF1R	colony stimulating factor 1 receptor 
CSF2	colony stimulating factor 2 
CSF2RA	colony stimulating factor 2 receptor alpha subunit 
CSF2RB	colony stimulating factor 2 receptor beta common subunit 
CSF3R	colony stimulating factor 3 receptor 
CSK	C-terminal Src kinase 
CSMD1	CUB and Sushi multiple domains 1 
CSN3	casein kappa 
CSNK1A1	casein kinase 1 alpha 1 
CSNK1E	casein kinase 1 epsilon 
CSNK1G1	casein kinase 1 gamma 1 
CSNK1G2	casein kinase 1 gamma 2 
CSNK1G3	casein kinase 1 gamma 3 
CSNK2A1	casein kinase 2 alpha 1 
CSNK2A2	casein kinase 2 alpha 2 
CSNK2A3	casein kinase 2 alpha 3 
CSNK2B	casein kinase 2 beta 
CSRNP3	cysteine and serine rich nuclear protein 3 
CSRP1	cysteine and glycine rich protein 1 
CSRP3	cysteine and glycine rich protein 3 
CST5	cystatin D 
CSTB	cystatin B 
CTBP1	C-terminal binding protein 1 
CTDSP1	CTD small phosphatase 1 
CTH	cystathionine gamma-lyase 
CTLA4	cytotoxic T-lymphocyte associated protein 4 
CTNNA2	catenin alpha 2 
CTNNA3	catenin alpha 3 
CTNNB1	catenin beta 1 
CTNS	cystinosin, lysosomal cystine transporter 
CTPS1	CTP synthase 1 
CTRB1	chymotrypsinogen B1 
CTSB	cathepsin B 
CTSD	cathepsin D 
CTSF	cathepsin F 
CTSG	cathepsin G 
CTSH	cathepsin H 
CTSK	cathepsin K 
CTSL	cathepsin L 
CTSS	cathepsin S 
CTSV	cathepsin V 
CUBN	cubilin 
CUX2	cut like homeobox 2 
CXCL10	C-X-C motif chemokine ligand 10 
CXCL12	C-X-C motif chemokine ligand 12 
CXCL5	C-X-C motif chemokine ligand 5 
CXCL8	C-X-C motif chemokine ligand 8 
CXCR1	C-X-C motif chemokine receptor 1 
CXCR4	C-X-C motif chemokine receptor 4 
CXXC4	CXXC finger protein 4 
CYB5A	cytochrome b5 type A 
CYB5B	cytochrome b5 type B 
CYB5R1	cytochrome b5 reductase 1 
CYB5R3	cytochrome b5 reductase 3 
CYBA	cytochrome b-245 alpha chain 
CYBB	cytochrome b-245 beta chain 
CYC1	cytochrome c1 
CYCS	cytochrome c, somatic 
CYCSP5	CYCS pseudogene 5 
CYP11A1	cytochrome P450 family 11 subfamily A member 1 
CYP11B1	cytochrome P450 family 11 subfamily B member 1 
CYP11B2	cytochrome P450 family 11 subfamily B member 2 
CYP17A1	cytochrome P450 family 17 subfamily A member 1 
CYP19A1	cytochrome P450 family 19 subfamily A member 1 
CYP1A1	cytochrome P450 family 1 subfamily A member 1 
CYP1A2	cytochrome P450 family 1 subfamily A member 2 
CYP1B1	cytochrome P450 family 1 subfamily B member 1 
CYP20A1	cytochrome P450 family 20 subfamily A member 1 
CYP21A2	cytochrome P450 family 21 subfamily A member 2 
CYP24A1	cytochrome P450 family 24 subfamily A member 1 
CYP26A1	cytochrome P450 family 26 subfamily A member 1 
CYP26B1	cytochrome P450 family 26 subfamily B member 1 
CYP26C1	cytochrome P450 family 26 subfamily C member 1 
CYP27A1	cytochrome P450 family 27 subfamily A member 1 
CYP27B1	cytochrome P450 family 27 subfamily B member 1 
CYP2A13	cytochrome P450 family 2 subfamily A member 13 
CYP2A6	cytochrome P450 family 2 subfamily A member 6 
CYP2A7	cytochrome P450 family 2 subfamily A member 7 
CYP2B6	cytochrome P450 family 2 subfamily B member 6 
CYP2B7P	cytochrome P450 family 2 subfamily B member 7, pseudogene 
CYP2C18	cytochrome P450 family 2 subfamily C member 18 
CYP2C19	cytochrome P450 family 2 subfamily C member 19 
CYP2C8	cytochrome P450 family 2 subfamily C member 8 
CYP2C9	cytochrome P450 family 2 subfamily C member 9 
CYP2D6	cytochrome P450 family 2 subfamily D member 6 
CYP2E1	cytochrome P450 family 2 subfamily E member 1 
CYP2F1	cytochrome P450 family 2 subfamily F member 1 
CYP2J2	cytochrome P450 family 2 subfamily J member 2 
CYP2R1	cytochrome P450 family 2 subfamily R member 1 
CYP2S1	cytochrome P450 family 2 subfamily S member 1 
CYP39A1	cytochrome P450 family 39 subfamily A member 1 
CYP3A4	cytochrome P450 family 3 subfamily A member 4 
CYP3A43	cytochrome P450 family 3 subfamily A member 43 
CYP3A5	cytochrome P450 family 3 subfamily A member 5 
CYP3A7	cytochrome P450 family 3 subfamily A member 7 
CYP46A1	cytochrome P450 family 46 subfamily A member 1 
CYP4A11	cytochrome P450 family 4 subfamily A member 11 
CYP4B1	cytochrome P450 family 4 subfamily B member 1 
CYP4F11	cytochrome P450 family 4 subfamily F member 11 
CYP4F12	cytochrome P450 family 4 subfamily F member 12 
CYP4F2	cytochrome P450 family 4 subfamily F member 2 
CYP4F8	cytochrome P450 family 4 subfamily F member 8 
CYP51A1	cytochrome P450 family 51 subfamily A member 1 
CYP7A1	cytochrome P450 family 7 subfamily A member 1 
CYP7B1	cytochrome P450 family 7 subfamily B member 1 
CYP8B1	cytochrome P450 family 8 subfamily B member 1 
CYSLTR1	cysteinyl leukotriene receptor 1 
CYSLTR2	cysteinyl leukotriene receptor 2 
CYTH2	cytohesin 2 
CYTH3	cytohesin 3 
DAGLA	diacylglycerol lipase alpha 
DAND5	DAN domain BMP antagonist family member 5 
DAO	D-amino acid oxidase 
DAOA	D-amino acid oxidase activator 
DAPK1	death associated protein kinase 1 
DAPK2	death associated protein kinase 2 
DAPK3	death associated protein kinase 3 
DAPP1	dual adaptor of phosphotyrosine and 3-phosphoinositides 1 
DARS1	aspartyl-tRNA synthetase 1 
DARS2	aspartyl-tRNA synthetase 2, mitochondrial 
DBH	dopamine beta-hydroxylase 
DBI	diazepam binding inhibitor, acyl-CoA binding protein 
DCAF4	DDB1 and CUL4 associated factor 4 
DCBLD1	discoidin, CUB and LCCL domain containing 1 
DCD	dermcidin 
DCK	deoxycytidine kinase 
DCLK1	doublecortin like kinase 1 
DCLK2	doublecortin like kinase 2 
DCLK3	doublecortin like kinase 3 
DCN	decorin 
DCPS	decapping enzyme, scavenger 
DCTD	dCMP deaminase 
DCXR	dicarbonyl and L-xylulose reductase 
DDAH1	dimethylarginine dimethylaminohydrolase 1 
DDAH2	dimethylarginine dimethylaminohydrolase 2 
DDC	dopa decarboxylase 
DDHD1	DDHD domain containing 1 
DDR1	discoidin domain receptor tyrosine kinase 1 
DDR2	discoidin domain receptor tyrosine kinase 2 
DDRGK1	DDRGK domain containing 1 
DDX39B	DExD-box helicase 39B 
DDX5	DEAD-box helicase 5 
DDX6	DEAD-box helicase 6 
DECR1	2,4-dienoyl-CoA reductase 1 
DGAT2	diacylglycerol O-acyltransferase 2 
DGKA	diacylglycerol kinase alpha 
DGKD	diacylglycerol kinase delta 
DGKG	diacylglycerol kinase gamma 
DGUOK	deoxyguanosine kinase 
DHCR7	7-dehydrocholesterol reductase 
DHFR	dihydrofolate reductase 
DHFR2	dihydrofolate reductase 2 
DHODH	dihydroorotate dehydrogenase (quinone) 
DHPS	deoxyhypusine synthase 
DHRS11	dehydrogenase/reductase 11 
DHRS3	dehydrogenase/reductase 3 
DHRS4	dehydrogenase/reductase 4 
DHRS4L1	dehydrogenase/reductase 4 like 1 
DHRS4L2	dehydrogenase/reductase 4 like 2 
DIABLO	diablo IAP-binding mitochondrial protein 
DIAPH3	diaphanous related formin 3 
DIO3	iodothyronine deiodinase 3 
DLAT	dihydrolipoamide S-acetyltransferase 
DLD	dihydrolipoamide dehydrogenase 
DLG4	discs large MAGUK scaffold protein 4 
DLG5	discs large MAGUK scaffold protein 5 
DMC1	DNA meiotic recombinase 1 
DMD	dystrophin 
DMPK	DM1 protein kinase 
DNMT1	DNA methyltransferase 1 
DNMT3A	DNA methyltransferase 3 alpha 
DNPEP	aspartyl aminopeptidase 
DNTT	DNA nucleotidylexotransferase 
DOK5	docking protein 5 
DOT1L	DOT1 like histone lysine methyltransferase 
DPEP1	dipeptidase 1 
DPH5	diphthamide biosynthesis 5 
DPP4	dipeptidyl peptidase 4 
DPYD	dihydropyrimidine dehydrogenase 
DPYS	dihydropyrimidinase 
DPYSL2	dihydropyrimidinase like 2 
DRD1	dopamine receptor D1 
DRD2	dopamine receptor D2 
DRD3	dopamine receptor D3 
DRD4	dopamine receptor D4 
DRD5	dopamine receptor D5 
DROSHA	drosha ribonuclease III 
DSCAM	DS cell adhesion molecule 
DSE	dermatan sulfate epimerase 
DSP	desmoplakin 
DSTN	destrin, actin depolymerizing factor 
DTNBP1	dystrobrevin binding protein 1 
DTYMK	deoxythymidylate kinase 
DUSP1	dual specificity phosphatase 1 
DUSP23	dual specificity phosphatase 23 
DUT	deoxyuridine triphosphatase 
DYNC2H1	dynein cytoplasmic 2 heavy chain 1 
DYRK1A	dual specificity tyrosine phosphorylation regulated kinase 1A 
DYRK1B	dual specificity tyrosine phosphorylation regulated kinase 1B 
E2F7	E2F transcription factor 7 
EARS2	glutamyl-tRNA synthetase 2, mitochondrial 
EBP	EBP cholestenol delta-isomerase 
ECE1	endothelin converting enzyme 1 
ECHS1	enoyl-CoA hydratase, short chain 1 
ECI1	enoyl-CoA delta isomerase 1 
ECI2	enoyl-CoA delta isomerase 2 
ECT2L	epithelial cell transforming 2 like 
EDN1	endothelin 1 
EDNRA	endothelin receptor type A 
EDNRB	endothelin receptor type B 
EEA1	early endosome antigen 1 
EEF1A1	eukaryotic translation elongation factor 1 alpha 1 
EEF2	eukaryotic translation elongation factor 2 
EFL1	elongation factor like GTPase 1 
EGF	epidermal growth factor 
EGFR	epidermal growth factor receptor 
EGLN1	egl-9 family hypoxia inducible factor 1 
EGLN2	egl-9 family hypoxia inducible factor 2 
EGLN3	egl-9 family hypoxia inducible factor 3 
EHHADH	enoyl-CoA hydratase and 3-hydroxyacyl CoA dehydrogenase 
EHMT2	euchromatic histone lysine methyltransferase 2 
EIF2AK1	eukaryotic translation initiation factor 2 alpha kinase 1 
EIF2AK2	eukaryotic translation initiation factor 2 alpha kinase 2 
EIF2AK4	eukaryotic translation initiation factor 2 alpha kinase 4 
EIF2S3	eukaryotic translation initiation factor 2 subunit gamma 
EIF3A	eukaryotic translation initiation factor 3 subunit A 
EIF3F	eukaryotic translation initiation factor 3 subunit F 
EIF4A1	eukaryotic translation initiation factor 4A1 
EIF4E	eukaryotic translation initiation factor 4E 
EIF6	eukaryotic translation initiation factor 6 
ELANE	elastase, neutrophil expressed 
ELN	elastin 
ELOVL4	ELOVL fatty acid elongase 4 
ELOVL5	ELOVL fatty acid elongase 5 
ELP5	elongator acetyltransferase complex subunit 5 
ELSPBP1	epididymal sperm binding protein 1 
EN2	engrailed homeobox 2 
ENG	endoglin 
ENO1	enolase 1 
ENO2	enolase 2 
ENO3	enolase 3 
ENOPH1	enolase-phosphatase 1 
ENOSF1	enolase superfamily member 1 
ENOX2	ecto-NOX disulfide-thiol exchanger 2 
ENPEP	glutamyl aminopeptidase 
ENPP1	ectonucleotide pyrophosphatase/phosphodiesterase 1 
EPAS1	endothelial PAS domain protein 1 
EPB41	erythrocyte membrane protein band 4.1 
EPCAM	epithelial cell adhesion molecule 
EPHA1	EPH receptor A1 
EPHA2	EPH receptor A2 
EPHA3	EPH receptor A3 
EPHA4	EPH receptor A4 
EPHA5	EPH receptor A5 
EPHA6	EPH receptor A6 
EPHA7	EPH receptor A7 
EPHA8	EPH receptor A8 
EPHB1	EPH receptor B1 
EPHB2	EPH receptor B2 
EPHB4	EPH receptor B4 
EPHB6	EPH receptor B6 
EPHX1	epoxide hydrolase 1 
EPHX2	epoxide hydrolase 2 
EPM2A	EPM2A glucan phosphatase, laforin 
EPN1	epsin 1 
EPOR	erythropoietin receptor 
EPRS1	glutamyl-prolyl-tRNA synthetase 1 
EPX	eosinophil peroxidase 
ERBB2	erb-b2 receptor tyrosine kinase 2 
ERBB3	erb-b2 receptor tyrosine kinase 3 
ERBB4	erb-b2 receptor tyrosine kinase 4 
ERCC1	ERCC excision repair 1, endonuclease non-catalytic subunit 
ERCC2	ERCC excision repair 2, TFIIH core complex helicase subunit 
ERCC3	ERCC excision repair 3, TFIIH core complex helicase subunit 
ERCC4	ERCC excision repair 4, endonuclease catalytic subunit 
ERCC5	ERCC excision repair 5, endonuclease 
ERICH3	glutamate rich 3 
ERN1	endoplasmic reticulum to nucleus signaling 1 
ERO1B	endoplasmic reticulum oxidoreductase 1 beta 
ESD	esterase D 
ESR1	estrogen receptor 1 
ESR2	estrogen receptor 2 
ESRRA	estrogen related receptor alpha 
ESRRB	estrogen related receptor beta 
ESRRG	estrogen related receptor gamma 
ESYT2	extended synaptotagmin 2 
ETFDH	electron transfer flavoprotein dehydrogenase 
EXO1	exonuclease 1 
EXTL2	exostosin like glycosyltransferase 2 
EYS	eyes shut homolog 
EZH2	enhancer of zeste 2 polycomb repressive complex 2 subunit 
F10	coagulation factor X 
F11	coagulation factor XI 
F12	coagulation factor XII 
F13A1	coagulation factor XIII A chain 
F13B	coagulation factor XIII B chain 
F2	coagulation factor II, thrombin 
F2R	coagulation factor II thrombin receptor 
F2RL3	F2R like thrombin or trypsin receptor 3 
F3	coagulation factor III, tissue factor 
F5	coagulation factor V 
F7	coagulation factor VII 
F8	coagulation factor VIII 
F9	coagulation factor IX 
FAAH	fatty acid amide hydrolase 
FABP1	fatty acid binding protein 1 
FABP2	fatty acid binding protein 2 
FABP3	fatty acid binding protein 3 
FABP4	fatty acid binding protein 4 
FABP5	fatty acid binding protein 5 
FABP6	fatty acid binding protein 6 
FABP7	fatty acid binding protein 7 
FADS1	fatty acid desaturase 1 
FADS2	fatty acid desaturase 2 
FAH	fumarylacetoacetate hydrolase 
FAM177A1	family with sequence similarity 177 member A1 
FAM178B	family with sequence similarity 178 member B 
FAP	fibroblast activation protein alpha 
FARP2	FERM, ARH/RhoGEF and pleckstrin domain protein 2 
FARS2	phenylalanyl-tRNA synthetase 2, mitochondrial 
FARSA	phenylalanyl-tRNA synthetase subunit alpha 
FARSB	phenylalanyl-tRNA synthetase subunit beta 
FASN	fatty acid synthase 
FBN2	fibrillin 2 
FBN3	fibrillin 3 
FBP1	fructose-bisphosphatase 1 
FBXL17	F-box and leucine rich repeat protein 17 
FBXL19	F-box and leucine rich repeat protein 19 
FBXO41	F-box protein 41 
FCER1A	Fc fragment of IgE receptor Ia 
FCER1G	Fc fragment of IgE receptor Ig 
FCER2	Fc fragment of IgE receptor II 
FCGR1A	Fc fragment of IgG receptor Ia 
FCGR1B	Fc fragment of IgG receptor Ib 
FCGR2A	Fc fragment of IgG receptor IIa 
FCGR2B	Fc fragment of IgG receptor IIb 
FCGR2C	Fc fragment of IgG receptor IIc (gene/pseudogene) 
FCGR3A	Fc fragment of IgG receptor IIIa 
FCGR3B	Fc fragment of IgG receptor IIIb 
FCN2	ficolin 2 
FCN3	ficolin 3 
FDFT1	farnesyl-diphosphate farnesyltransferase 1 
FDPS	farnesyl diphosphate synthase 
FDX1	ferredoxin 1 
FDXR	ferredoxin reductase 
FECH	ferrochelatase 
FEN1	flap structure-specific endonuclease 1 
FER	FER tyrosine kinase 
FES	FES proto-oncogene, tyrosine kinase 
FFAR1	free fatty acid receptor 1 
FFAR4	free fatty acid receptor 4 
FGA	fibrinogen alpha chain 
FGB	fibrinogen beta chain 
FGD4	FYVE, RhoGEF and PH domain containing 4 
FGF1	fibroblast growth factor 1 
FGF19	fibroblast growth factor 19 
FGF2	fibroblast growth factor 2 
FGF23	fibroblast growth factor 23 
FGF4	fibroblast growth factor 4 
FGFR1	fibroblast growth factor receptor 1 
FGFR2	fibroblast growth factor receptor 2 
FGFR3	fibroblast growth factor receptor 3 
FGFR4	fibroblast growth factor receptor 4 
FGG	fibrinogen gamma chain 
FGR	FGR proto-oncogene, Src family tyrosine kinase 
FHIT	fragile histidine triad diadenosine triphosphatase 
FKBP1A	FKBP prolyl isomerase 1A 
FKBP5	FKBP prolyl isomerase 5 
FLNA	filamin A 
FLT1	fms related tyrosine kinase 1 
FLT3	fms related tyrosine kinase 3 
FLT4	fms related tyrosine kinase 4 
FMO1	flavin containing dimethylaniline monoxygenase 1 
FMO2	flavin containing dimethylaniline monoxygenase 2 
FMO3	flavin containing dimethylaniline monoxygenase 3 
FMO4	flavin containing dimethylaniline monoxygenase 4 
FMO5	flavin containing dimethylaniline monoxygenase 5 
FN1	fibronectin 1 
FNTA	farnesyltransferase, CAAX box, alpha 
FNTB	farnesyltransferase, CAAX box, beta 
FOLH1	folate hydrolase 1 
FOLR1	folate receptor alpha 
FOLR2	folate receptor beta 
FOLR3	folate receptor gamma 
FOS	Fos proto-oncogene, AP-1 transcription factor subunit 
FOXF2	forkhead box F2 
FOXO1	forkhead box O1 
FOXP3	forkhead box P3 
FPGS	folylpolyglutamate synthase 
FPR1	formyl peptide receptor 1 
FRK	fyn related Src family tyrosine kinase 
FSHR	follicle stimulating hormone receptor 
FSIP1	fibrous sheath interacting protein 1 
FST	follistatin 
FTCD	formimidoyltransferase cyclodeaminase 
FTH1	ferritin heavy chain 1 
FTL	ferritin light chain 
FTO	FTO alpha-ketoglutarate dependent dioxygenase 
FUBP1	far upstream element binding protein 1 
FURIN	furin, paired basic amino acid cleaving enzyme 
FXN	frataxin 
FXR2	FMR1 autosomal homolog 2 
FXYD2	FXYD domain containing ion transport regulator 2 
FYN	FYN proto-oncogene, Src family tyrosine kinase 
G6PD	glucose-6-phosphate dehydrogenase 
GAA	glucosidase alpha, acid 
GABBR1	gamma-aminobutyric acid type B receptor subunit 1 
GABBR2	gamma-aminobutyric acid type B receptor subunit 2 
GABRA1	gamma-aminobutyric acid type A receptor alpha1 subunit 
GABRA2	gamma-aminobutyric acid type A receptor alpha2 subunit 
GABRA3	gamma-aminobutyric acid type A receptor alpha3 subunit 
GABRA4	gamma-aminobutyric acid type A receptor alpha4 subunit 
GABRA5	gamma-aminobutyric acid type A receptor alpha5 subunit 
GABRA6	gamma-aminobutyric acid type A receptor alpha6 subunit 
GABRB1	gamma-aminobutyric acid type A receptor beta1 subunit 
GABRB2	gamma-aminobutyric acid type A receptor beta2 subunit 
GABRB3	gamma-aminobutyric acid type A receptor beta3 subunit 
GABRD	gamma-aminobutyric acid type A receptor delta subunit 
GABRE	gamma-aminobutyric acid type A receptor epsilon subunit 
GABRG1	gamma-aminobutyric acid type A receptor gamma1 subunit 
GABRG2	gamma-aminobutyric acid type A receptor gamma2 subunit 
GABRG3	gamma-aminobutyric acid type A receptor gamma3 subunit 
GABRP	gamma-aminobutyric acid type A receptor pi subunit 
GABRQ	gamma-aminobutyric acid type A receptor theta subunit 
GABRR1	gamma-aminobutyric acid type A receptor rho1 subunit 
GABRR2	gamma-aminobutyric acid type A receptor rho2 subunit 
GABRR3	gamma-aminobutyric acid type A receptor rho3 subunit (gene/pseudogene) 
GAD1	glutamate decarboxylase 1 
GAD2	glutamate decarboxylase 2 
GADL1	glutamate decarboxylase like 1 
GAK	cyclin G associated kinase 
GAL	galanin and GMAP prepropeptide 
GALE	UDP-galactose-4-epimerase 
GALK1	galactokinase 1 
GALNS	galactosamine (N-acetyl)-6-sulfatase 
GALNT14	polypeptide N-acetylgalactosaminyltransferase 14 
GALNT17	polypeptide N-acetylgalactosaminyltransferase 17 
GALNT18	polypeptide N-acetylgalactosaminyltransferase 18 
GALNT2	polypeptide N-acetylgalactosaminyltransferase 2 
GALR1	galanin receptor 1 
GAMT	guanidinoacetate N-methyltransferase 
GANAB	glucosidase II alpha subunit 
GANC	glucosidase alpha, neutral C 
GAPDH	glyceraldehyde-3-phosphate dehydrogenase 
GAPDHS	glyceraldehyde-3-phosphate dehydrogenase, spermatogenic 
GAPVD1	GTPase activating protein and VPS9 domains 1 
GARS1	glycyl-tRNA synthetase 1 
GART	phosphoribosylglycinamide formyltransferase, phosphoribosylglycinamide synthetase, phosphoribosylaminoimidazole synthetase 
GAST	gastrin 
GATA3	GATA binding protein 3 
GATA4	GATA binding protein 4 
GATB	glutamyl-tRNA amidotransferase subunit B 
GATM	glycine amidinotransferase 
GBA	glucosylceramidase beta 
GBP6	guanylate binding protein family member 6 
GC	GC vitamin D binding protein 
GCA	grancalcin 
GCAT	glycine C-acetyltransferase 
GCDH	glutaryl-CoA dehydrogenase 
GCG	glucagon 
GCGR	glucagon receptor 
GCH1	GTP cyclohydrolase 1 
GCK	glucokinase 
GCLC	glutamate-cysteine ligase catalytic subunit 
GCLM	glutamate-cysteine ligase modifier subunit 
GCSH	glycine cleavage system protein H 
GDF5	growth differentiation factor 5 
GDNF	glial cell derived neurotrophic factor 
GET1	guided entry of tail-anchored proteins factor 1 
GET3	guided entry of tail-anchored proteins factor 3, ATPase 
GFER	growth factor, augmenter of liver regeneration 
GFPT2	glutamine-fructose-6-phosphate transaminase 2 
GGACT	gamma-glutamylamine cyclotransferase 
GGCX	gamma-glutamyl carboxylase 
GGH	gamma-glutamyl hydrolase 
GGPS1	geranylgeranyl diphosphate synthase 1 
GGT1	gamma-glutamyltransferase 1 
GHR	growth hormone receptor 
GHRHR	growth hormone releasing hormone receptor 
GHSR	growth hormone secretagogue receptor 
GIPR	gastric inhibitory polypeptide receptor 
GJA1	gap junction protein alpha 1 
GLA	galactosidase alpha 
GLCCI1	glucocorticoid induced 1 
GLDC	glycine decarboxylase 
GLIPR1	GLI pathogenesis related 1 
GLIPR2	GLI pathogenesis related 2 
GLO1	glyoxalase I 
GLP1R	glucagon like peptide 1 receptor 
GLP2R	glucagon like peptide 2 receptor 
GLRA1	glycine receptor alpha 1 
GLRA2	glycine receptor alpha 2 
GLRA3	glycine receptor alpha 3 
GLRB	glycine receptor beta 
GLRX	glutaredoxin 
GLRX2	glutaredoxin 2 
GLS	glutaminase 
GLS2	glutaminase 2 
GLT6D1	glycosyltransferase 6 domain containing 1 
GLTP	glycolipid transfer protein 
GLUD1	glutamate dehydrogenase 1 
GLUD2	glutamate dehydrogenase 2 
GLUL	glutamate-ammonia ligase 
GLYAT	glycine-N-acyltransferase 
GLYATL1	glycine-N-acyltransferase like 1 
GLYATL2	glycine-N-acyltransferase like 2 
GM2A	GM2 ganglioside activator 
GMDS	GDP-mannose 4,6-dehydratase 
GMPR	guanosine monophosphate reductase 
GMPS	guanine monophosphate synthase 
GNAI1	G protein subunit alpha i1 
GNAS	GNAS complex locus 
GNAT1	G protein subunit alpha transducin 1 
GNB3	G protein subunit beta 3 
GNG2	G protein subunit gamma 2 
GNL3	G protein nucleolar 3 
GNLY	granulysin 
GNMT	glycine N-methyltransferase 
GNPDA1	glucosamine-6-phosphate deaminase 1 
GNRHR	gonadotropin releasing hormone receptor 
GNRHR2	gonadotropin releasing hormone receptor 2 (pseudogene) 
GOT1	glutamic-oxaloacetic transaminase 1 
GOT2	glutamic-oxaloacetic transaminase 2 
GP1BA	glycoprotein Ib platelet subunit alpha 
GP6	glycoprotein VI platelet 
GP9	glycoprotein IX platelet 
GPBAR1	G protein-coupled bile acid receptor 1 
GPD1	glycerol-3-phosphate dehydrogenase 1 
GPER1	G protein-coupled estrogen receptor 1 
GPHN	gephyrin 
GPI	glucose-6-phosphate isomerase 
GPNMB	glycoprotein nmb 
GPR119	G protein-coupled receptor 119 
GPR12	G protein-coupled receptor 12 
GPR18	G protein-coupled receptor 18 
GPR35	G protein-coupled receptor 35 
GPR55	G protein-coupled receptor 55 
GPR83	G protein-coupled receptor 83 
GPRC5A	G protein-coupled receptor class C group 5 member A 
GPT	glutamic--pyruvic transaminase 
GPT2	glutamic--pyruvic transaminase 2 
GPX1	glutathione peroxidase 1 
GPX2	glutathione peroxidase 2 
GPX3	glutathione peroxidase 3 
GPX4	glutathione peroxidase 4 
GPX5	glutathione peroxidase 5 
GPX6	glutathione peroxidase 6 
GPX7	glutathione peroxidase 7 
GPX8	glutathione peroxidase 8 (putative) 
GRAMD1B	GRAM domain containing 1B 
GRB2	growth factor receptor bound protein 2 
GREM2	gremlin 2, DAN family BMP antagonist 
GRIA1	glutamate ionotropic receptor AMPA type subunit 1 
GRIA2	glutamate ionotropic receptor AMPA type subunit 2 
GRIA3	glutamate ionotropic receptor AMPA type subunit 3 
GRIA4	glutamate ionotropic receptor AMPA type subunit 4 
GRID1	glutamate ionotropic receptor delta type subunit 1 
GRID2	glutamate ionotropic receptor delta type subunit 2 
GRIK1	glutamate ionotropic receptor kainate type subunit 1 
GRIK2	glutamate ionotropic receptor kainate type subunit 2 
GRIK3	glutamate ionotropic receptor kainate type subunit 3 
GRIK4	glutamate ionotropic receptor kainate type subunit 4 
GRIK5	glutamate ionotropic receptor kainate type subunit 5 
GRIN1	glutamate ionotropic receptor NMDA type subunit 1 
GRIN2A	glutamate ionotropic receptor NMDA type subunit 2A 
GRIN2B	glutamate ionotropic receptor NMDA type subunit 2B 
GRIN2C	glutamate ionotropic receptor NMDA type subunit 2C 
GRIN2D	glutamate ionotropic receptor NMDA type subunit 2D 
GRIN3A	glutamate ionotropic receptor NMDA type subunit 3A 
GRIN3B	glutamate ionotropic receptor NMDA type subunit 3B 
GRK2	G protein-coupled receptor kinase 2 
GRK3	G protein-coupled receptor kinase 3 
GRK4	G protein-coupled receptor kinase 4 
GRK5	G protein-coupled receptor kinase 5 
GRM1	glutamate metabotropic receptor 1 
GRM2	glutamate metabotropic receptor 2 
GRM3	glutamate metabotropic receptor 3 
GRM4	glutamate metabotropic receptor 4 
GRM5	glutamate metabotropic receptor 5 
GRM7	glutamate metabotropic receptor 7 
GRM8	glutamate metabotropic receptor 8 
GSK3A	glycogen synthase kinase 3 alpha 
GSK3B	glycogen synthase kinase 3 beta 
GSN	gelsolin 
GSPT1	G1 to S phase transition 1 
GSR	glutathione-disulfide reductase 
GSS	glutathione synthetase 
GSTA1	glutathione S-transferase alpha 1 
GSTA2	glutathione S-transferase alpha 2 
GSTA3	glutathione S-transferase alpha 3 
GSTA4	glutathione S-transferase alpha 4 
GSTA5	glutathione S-transferase alpha 5 
GSTK1	glutathione S-transferase kappa 1 
GSTM1	glutathione S-transferase mu 1 
GSTM2	glutathione S-transferase mu 2 
GSTM3	glutathione S-transferase mu 3 
GSTM4	glutathione S-transferase mu 4 
GSTM5	glutathione S-transferase mu 5 
GSTO1	glutathione S-transferase omega 1 
GSTO2	glutathione S-transferase omega 2 
GSTP1	glutathione S-transferase pi 1 
GSTT1	glutathione S-transferase theta 1 
GSTT2	glutathione S-transferase theta 2 (gene/pseudogene) 
GSTT2B	glutathione S-transferase theta 2B (gene/pseudogene) 
GSTZ1	glutathione S-transferase zeta 1 
GUCA1A	guanylate cyclase activator 1A 
GUCY1A2	guanylate cyclase 1 soluble subunit alpha 2 
GUCY2C	guanylate cyclase 2C 
GUK1	guanylate kinase 1 
GUSB	glucuronidase beta 
GYG1	glycogenin 1 
H1-4	H1.4 linker histone, cluster member 
H19	H19 imprinted maternally expressed transcript 
H2BC10	H2B clustered histone 10 
H6PD	hexose-6-phosphate dehydrogenase/glucose 1-dehydrogenase 
HABP2	hyaluronan binding protein 2 
HABP4	hyaluronan binding protein 4 
HADH	hydroxyacyl-CoA dehydrogenase 
HADHA	hydroxyacyl-CoA dehydrogenase trifunctional multienzyme complex subunit alpha 
HAGH	hydroxyacylglutathione hydrolase 
HAL	histidine ammonia-lyase 
HAO1	hydroxyacid oxidase 1 
HAO2	hydroxyacid oxidase 2 
HAPLN1	hyaluronan and proteoglycan link protein 1 
HAPLN3	hyaluronan and proteoglycan link protein 3 
HAPLN4	hyaluronan and proteoglycan link protein 4 
HARS1	histidyl-tRNA synthetase 1 
HAS3	hyaluronan synthase 3 
HASPIN	histone H3 associated protein kinase 
HBA1	hemoglobin subunit alpha 1 
HBB	hemoglobin subunit beta 
HCAR2	hydroxycarboxylic acid receptor 2 
HCAR3	hydroxycarboxylic acid receptor 3 
HCG22	HLA complex group 22 (gene/pseudogene) 
HCK	HCK proto-oncogene, Src family tyrosine kinase 
HCN2	hyperpolarization activated cyclic nucleotide gated potassium and sodium channel 2 
HCRT	hypocretin neuropeptide precursor 
HCRTR1	hypocretin receptor 1 
HCRTR2	hypocretin receptor 2 
HDAC1	histone deacetylase 1 
HDAC10	histone deacetylase 10 
HDAC11	histone deacetylase 11 
HDAC2	histone deacetylase 2 
HDAC3	histone deacetylase 3 
HDAC4	histone deacetylase 4 
HDAC5	histone deacetylase 5 
HDAC6	histone deacetylase 6 
HDAC7	histone deacetylase 7 
HDAC8	histone deacetylase 8 
HDAC9	histone deacetylase 9 
HDC	histidine decarboxylase 
HDGF	heparin binding growth factor 
HEPH	hephaestin 
HEPHL1	hephaestin like 1 
HEXB	hexosaminidase subunit beta 
HFE	homeostatic iron regulator 
HGF	hepatocyte growth factor 
HGS	hepatocyte growth factor-regulated tyrosine kinase substrate 
HIBADH	3-hydroxyisobutyrate dehydrogenase 
HIBCH	3-hydroxyisobutyryl-CoA hydrolase 
HIF1A	hypoxia inducible factor 1 subunit alpha 
HIF1AN	hypoxia inducible factor 1 subunit alpha inhibitor 
HINT1	histidine triad nucleotide binding protein 1 
HIPK2	homeodomain interacting protein kinase 2 
HIPK3	homeodomain interacting protein kinase 3 
HK1	hexokinase 1 
HLA-A	major histocompatibility complex, class I, A 
HLA-B	major histocompatibility complex, class I, B 
HLA-C	major histocompatibility complex, class I, C 
HLA-DPA1	major histocompatibility complex, class II, DP alpha 1 
HLA-DPB1	major histocompatibility complex, class II, DP beta 1 
HLA-DPB2	major histocompatibility complex, class II, DP beta 2 (pseudogene) 
HLA-DQA1	major histocompatibility complex, class II, DQ alpha 1 
HLA-DQA2	major histocompatibility complex, class II, DQ alpha 2 
HLA-DQB1	major histocompatibility complex, class II, DQ beta 1 
HLA-DQB3	major histocompatibility complex, class II, DQ beta 3 
HLA-DRA	major histocompatibility complex, class II, DR alpha 
HLA-DRB1	major histocompatibility complex, class II, DR beta 1 
HLA-DRB3	major histocompatibility complex, class II, DR beta 3 
HLA-DRB4	major histocompatibility complex, class II, DR beta 4 
HLA-DRB5	major histocompatibility complex, class II, DR beta 5 
HLA-E	major histocompatibility complex, class I, E 
HLA-G	major histocompatibility complex, class I, G 
HLCS	holocarboxylase synthetase 
HM13	histocompatibility minor 13 
HMBS	hydroxymethylbilane synthase 
HMGB1	high mobility group box 1 
HMGCL	3-hydroxy-3-methylglutaryl-CoA lyase 
HMGCR	3-hydroxy-3-methylglutaryl-CoA reductase 
HMGCS1	3-hydroxy-3-methylglutaryl-CoA synthase 1 
HMGCS2	3-hydroxy-3-methylglutaryl-CoA synthase 2 
HMMR	hyaluronan mediated motility receptor 
HMOX1	heme oxygenase 1 
HMOX2	heme oxygenase 2 
HNF1A	HNF1 homeobox A 
HNF4A	hepatocyte nuclear factor 4 alpha 
HNF4G	hepatocyte nuclear factor 4 gamma 
HNMT	histamine N-methyltransferase 
HNRNPA2B1	heterogeneous nuclear ribonucleoprotein A2/B1 
HNRNPD	heterogeneous nuclear ribonucleoprotein D 
HNRNPF	heterogeneous nuclear ribonucleoprotein F 
HNRNPH1	heterogeneous nuclear ribonucleoprotein H1 
HNRNPH2	heterogeneous nuclear ribonucleoprotein H2 
HNRNPH3	heterogeneous nuclear ribonucleoprotein H3 
HNRNPK	heterogeneous nuclear ribonucleoprotein K 
HNRNPL	heterogeneous nuclear ribonucleoprotein L 
HOMER1	homer scaffold protein 1 
HOTAIR	HOX transcript antisense RNA 
HOXA10	homeobox A10 
HP1BP3	heterochromatin protein 1 binding protein 3 
HPD	4-hydroxyphenylpyruvate dioxygenase 
HPGD	15-hydroxyprostaglandin dehydrogenase 
HPGDS	hematopoietic prostaglandin D synthase 
HPN	hepsin 
HPR	haptoglobin-related protein 
HPRT1	hypoxanthine phosphoribosyltransferase 1 
HPSE	heparanase 
HRAS	HRas proto-oncogene, GTPase 
HRH1	histamine receptor H1 
HRH2	histamine receptor H2 
HRH3	histamine receptor H3 
HRH4	histamine receptor H4 
HRNR	hornerin 
HS3ST1	heparan sulfate-glucosamine 3-sulfotransferase 1 
HS3ST3A1	heparan sulfate-glucosamine 3-sulfotransferase 3A1 
HSD11B1	hydroxysteroid 11-beta dehydrogenase 1 
HSD11B2	hydroxysteroid 11-beta dehydrogenase 2 
HSD17B1	hydroxysteroid 17-beta dehydrogenase 1 
HSD17B10	hydroxysteroid 17-beta dehydrogenase 10 
HSD17B11	hydroxysteroid 17-beta dehydrogenase 11 
HSD17B2	hydroxysteroid 17-beta dehydrogenase 2 
HSD17B3	hydroxysteroid 17-beta dehydrogenase 3 
HSD17B4	hydroxysteroid 17-beta dehydrogenase 4 
HSD17B6	hydroxysteroid 17-beta dehydrogenase 6 
HSD17B7	hydroxysteroid 17-beta dehydrogenase 7 
HSD17B8	hydroxysteroid 17-beta dehydrogenase 8 
HSD3B1	hydroxy-delta-5-steroid dehydrogenase, 3 beta- and steroid delta-isomerase 1 
HSD3B2	hydroxy-delta-5-steroid dehydrogenase, 3 beta- and steroid delta-isomerase 2 
HSF1	heat shock transcription factor 1 
HSP90AA1	heat shock protein 90 alpha family class A member 1 
HSP90AB1	heat shock protein 90 alpha family class B member 1 
HSP90B1	heat shock protein 90 beta family member 1 
HSPA13	heat shock protein family A (Hsp70) member 13 
HSPA1A	heat shock protein family A (Hsp70) member 1A 
HSPA1L	heat shock protein family A (Hsp70) member 1 like 
HSPA2	heat shock protein family A (Hsp70) member 2 
HSPA4	heat shock protein family A (Hsp70) member 4 
HSPA5	heat shock protein family A (Hsp70) member 5 
HSPA8	heat shock protein family A (Hsp70) member 8 
HSPB1	heat shock protein family B (small) member 1 
HSPD1	heat shock protein family D (Hsp60) member 1 
HSPE1	heat shock protein family E (Hsp10) member 1 
HSPG2	heparan sulfate proteoglycan 2 
HSPH1	heat shock protein family H (Hsp110) member 1 
HTATIP2	HIV-1 Tat interactive protein 2 
HTR1A	5-hydroxytryptamine receptor 1A 
HTR1B	5-hydroxytryptamine receptor 1B 
HTR1D	5-hydroxytryptamine receptor 1D 
HTR1E	5-hydroxytryptamine receptor 1E 
HTR1F	5-hydroxytryptamine receptor 1F 
HTR2A	5-hydroxytryptamine receptor 2A 
HTR2B	5-hydroxytryptamine receptor 2B 
HTR2C	5-hydroxytryptamine receptor 2C 
HTR3A	5-hydroxytryptamine receptor 3A 
HTR3B	5-hydroxytryptamine receptor 3B 
HTR3C	5-hydroxytryptamine receptor 3C 
HTR3D	5-hydroxytryptamine receptor 3D 
HTR3E	5-hydroxytryptamine receptor 3E 
HTR4	5-hydroxytryptamine receptor 4 
HTR5A	5-hydroxytryptamine receptor 5A 
HTR6	5-hydroxytryptamine receptor 6 
HTR7	5-hydroxytryptamine receptor 7 
HTRA1	HtrA serine peptidase 1 
HTT	huntingtin 
HYKK	hydroxylysine kinase 
IAPP	islet amyloid polypeptide 
IARS1	isoleucyl-tRNA synthetase 1 
IARS2	isoleucyl-tRNA synthetase 2, mitochondrial 
ICAM1	intercellular adhesion molecule 1 
ICK	intestinal cell kinase 
IDE	insulin degrading enzyme 
IDH1	isocitrate dehydrogenase (NADP(+)) 1 
IDH2	isocitrate dehydrogenase (NADP(+)) 2 
IDH3A	isocitrate dehydrogenase (NAD(+)) 3 catalytic subunit alpha 
IDH3B	isocitrate dehydrogenase (NAD(+)) 3 non-catalytic subunit beta 
IDH3G	isocitrate dehydrogenase (NAD(+)) 3 non-catalytic subunit gamma 
IDI1	isopentenyl-diphosphate delta isomerase 1 
IDO1	indoleamine 2,3-dioxygenase 1 
IDS	iduronate 2-sulfatase 
IDUA	alpha-L-iduronidase 
IFNA2	interferon alpha 2 
IFNAR1	interferon alpha and beta receptor subunit 1 
IFNAR2	interferon alpha and beta receptor subunit 2 
IFNB1	interferon beta 1 
IFNG	interferon gamma 
IFNGR1	interferon gamma receptor 1 
IFNGR2	interferon gamma receptor 2 
IFNL3	interferon lambda 3 
IFNL4	interferon lambda 4 (gene/pseudogene) 
IGF1	insulin like growth factor 1 
IGF1R	insulin like growth factor 1 receptor 
IGF2BP2	insulin like growth factor 2 mRNA binding protein 2 
IGF2R	insulin like growth factor 2 receptor 
IGFALS	insulin like growth factor binding protein acid labile subunit 
IGFBP1	insulin like growth factor binding protein 1 
IGFBP2	insulin like growth factor binding protein 2 
IGFBP3	insulin like growth factor binding protein 3 
IGFBP4	insulin like growth factor binding protein 4 
IGFBP5	insulin like growth factor binding protein 5 
IGFBP6	insulin like growth factor binding protein 6 
IGFBP7	insulin like growth factor binding protein 7 
IGHA1	immunoglobulin heavy constant alpha 1 
IGHA2	immunoglobulin heavy constant alpha 2 (A2m marker) 
IGHG1	immunoglobulin heavy constant gamma 1 (G1m marker) 
IGHG2	immunoglobulin heavy constant gamma 2 (G2m marker) 
IGHG4	immunoglobulin heavy constant gamma 4 (G4m marker) 
IGHM	immunoglobulin heavy constant mu 
IGHV1-2	immunoglobulin heavy variable 1-2 
IGHV3-23	immunoglobulin heavy variable 3-23 
IGHV3-30	immunoglobulin heavy variable 3-30 
IGKC	immunoglobulin kappa constant 
IGKV1-17	immunoglobulin kappa variable 1-17 
IGKV1D-33	immunoglobulin kappa variable 1D-33 
IGKV2-30	immunoglobulin kappa variable 2-30 
IGKV2D-28	immunoglobulin kappa variable 2D-28 
IGKV3-20	immunoglobulin kappa variable 3-20 
IGKV4-1	immunoglobulin kappa variable 4-1 
IGLC1	immunoglobulin lambda constant 1 
IGLL1	immunoglobulin lambda like polypeptide 1 
IGLV2-8	immunoglobulin lambda variable 2-8 
IGLV3-21	immunoglobulin lambda variable 3-21 
IGLV7-43	immunoglobulin lambda variable 7-43 
IGSF10	immunoglobulin superfamily member 10 
IKBKB	inhibitor of nuclear factor kappa B kinase subunit beta 
IKBKE	inhibitor of nuclear factor kappa B kinase subunit epsilon 
IKBKG	inhibitor of nuclear factor kappa B kinase regulatory subunit gamma 
IL10	interleukin 10 
IL11	interleukin 11 
IL11RA	interleukin 11 receptor subunit alpha 
IL12A	interleukin 12A 
IL12B	interleukin 12B 
IL13	interleukin 13 
IL13RA2	interleukin 13 receptor subunit alpha 2 
IL15	interleukin 15 
IL16	interleukin 16 
IL17A	interleukin 17A 
IL17RA	interleukin 17 receptor A 
IL18	interleukin 18 
IL1A	interleukin 1 alpha 
IL1B	interleukin 1 beta 
IL1R1	interleukin 1 receptor type 1 
IL1RN	interleukin 1 receptor antagonist 
IL2	interleukin 2 
IL23A	interleukin 23 subunit alpha 
IL23R	interleukin 23 receptor 
IL2RA	interleukin 2 receptor subunit alpha 
IL2RB	interleukin 2 receptor subunit beta 
IL2RG	interleukin 2 receptor subunit gamma 
IL3	interleukin 3 
IL3RA	interleukin 3 receptor subunit alpha 
IL4	interleukin 4 
IL4I1	interleukin 4 induced 1 
IL4R	interleukin 4 receptor 
IL5	interleukin 5 
IL5RA	interleukin 5 receptor subunit alpha 
IL6	interleukin 6 
IL6R	interleukin 6 receptor 
ILKAP	ILK associated serine/threonine phosphatase 
IMPA1	inositol monophosphatase 1 
IMPA2	inositol monophosphatase 2 
IMPDH1	inosine monophosphate dehydrogenase 1 
IMPDH2	inosine monophosphate dehydrogenase 2 
IMPG2	interphotoreceptor matrix proteoglycan 2 
INCENP	inner centromere protein 
INPP1	inositol polyphosphate-1-phosphatase 
INPP5B	inositol polyphosphate-5-phosphatase B 
INS	insulin 
INSIG2	insulin induced gene 2 
INSR	insulin receptor 
INSRR	insulin receptor related receptor 
INVS	inversin 
IQGAP1	IQ motif containing GTPase activating protein 1 
IRAK1	interleukin 1 receptor associated kinase 1 
IRAK3	interleukin 1 receptor associated kinase 3 
IRAK4	interleukin 1 receptor associated kinase 4
IRF6	interferon regulatory factor 6 
IRGC	immunity related GTPase cinema 
IRS1	insulin receptor substrate 1 
ISG20	interferon stimulated exonuclease gene 20 
ISYNA1	inositol-3-phosphate synthase 1 
ITGA2	integrin subunit alpha 2 
ITGA2B	integrin subunit alpha 2b 
ITGA4	integrin subunit alpha 4 
ITGA5	integrin subunit alpha 5 
ITGAL	integrin subunit alpha L 
ITGAV	integrin subunit alpha V 
ITGB1	integrin subunit beta 1 
ITGB3	integrin subunit beta 3 
ITGB4	integrin subunit beta 4 
ITGB7	integrin subunit beta 7 
ITIH1	inter-alpha-trypsin inhibitor heavy chain 1 
ITIH2	inter-alpha-trypsin inhibitor heavy chain 2 
ITIH3	inter-alpha-trypsin inhibitor heavy chain 3 
ITIH4	inter-alpha-trypsin inhibitor heavy chain 4 
ITK	IL2 inducible T cell kinase 
ITPA	inosine triphosphatase 
ITPKA	inositol-trisphosphate 3-kinase A 
ITPR1	inositol 1,4,5-trisphosphate receptor type 1 
ITPR2	inositol 1,4,5-trisphosphate receptor type 2 
ITPR3	inositol 1,4,5-trisphosphate receptor type 3 
IVD	isovaleryl-CoA dehydrogenase 
IYD	iodotyrosine deiodinase 
JAK1	Janus kinase 1 
JAK2	Janus kinase 2 
JAK3	Janus kinase 3 
JCHAIN	joining chain of multimeric IgA and IgM 
JDP2	Jun dimerization protein 2 
JUN	Jun proto-oncogene, AP-1 transcription factor subunit 
JUP	junction plakoglobin 
KANSL3	KAT8 regulatory NSL complex subunit 3 
KARS1	lysyl-tRNA synthetase 1 
KAT2A	lysine acetyltransferase 2A 
KAT2B	lysine acetyltransferase 2B 
KAT5	lysine acetyltransferase 5 
KCNA1	potassium voltage-gated channel subfamily A member 1 
KCNA10	potassium voltage-gated channel subfamily A member 10 
KCNA2	potassium voltage-gated channel subfamily A member 2 
KCNA3	potassium voltage-gated channel subfamily A member 3 
KCNA4	potassium voltage-gated channel subfamily A member 4 
KCNA5	potassium voltage-gated channel subfamily A member 5 
KCNA6	potassium voltage-gated channel subfamily A member 6 
KCNA7	potassium voltage-gated channel subfamily A member 7 
KCNB1	potassium voltage-gated channel subfamily B member 1 
KCNB2	potassium voltage-gated channel subfamily B member 2 
KCNC1	potassium voltage-gated channel subfamily C member 1 
KCNC2	potassium voltage-gated channel subfamily C member 2 
KCNC3	potassium voltage-gated channel subfamily C member 3 
KCNC4	potassium voltage-gated channel subfamily C member 4 
KCND1	potassium voltage-gated channel subfamily D member 1 
KCND2	potassium voltage-gated channel subfamily D member 2 
KCND3	potassium voltage-gated channel subfamily D member 3 
KCNE1	potassium voltage-gated channel subfamily E regulatory subunit 1 
KCNE2	potassium voltage-gated channel subfamily E regulatory subunit 2 
KCNH1	potassium voltage-gated channel subfamily H member 1 
KCNH2	potassium voltage-gated channel subfamily H member 2 
KCNH6	potassium voltage-gated channel subfamily H member 6 
KCNH7	potassium voltage-gated channel subfamily H member 7 
KCNIP1	potassium voltage-gated channel interacting protein 1 
KCNIP4	potassium voltage-gated channel interacting protein 4 
KCNJ1	potassium inwardly rectifying channel subfamily J member 1 
KCNJ10	potassium inwardly rectifying channel subfamily J member 10 
KCNJ11	potassium inwardly rectifying channel subfamily J member 11 
KCNJ12	potassium inwardly rectifying channel subfamily J member 12 
KCNJ14	potassium inwardly rectifying channel subfamily J member 14 
KCNJ15	potassium inwardly rectifying channel subfamily J member 15 
KCNJ2	potassium inwardly rectifying channel subfamily J member 2 
KCNJ3	potassium inwardly rectifying channel subfamily J member 3 
KCNJ4	potassium inwardly rectifying channel subfamily J member 4 
KCNJ5	potassium inwardly rectifying channel subfamily J member 5 
KCNJ6	potassium inwardly rectifying channel subfamily J member 6 
KCNJ8	potassium inwardly rectifying channel subfamily J member 8 
KCNJ9	potassium inwardly rectifying channel subfamily J member 9 
KCNK1	potassium two pore domain channel subfamily K member 1 
KCNK2	potassium two pore domain channel subfamily K member 2 
KCNK3	potassium two pore domain channel subfamily K member 3 
KCNK6	potassium two pore domain channel subfamily K member 6 
KCNK9	potassium two pore domain channel subfamily K member 9 
KCNMA1	potassium calcium-activated channel subfamily M alpha 1 
KCNMB1	potassium calcium-activated channel subfamily M regulatory beta subunit 1 
KCNMB2	potassium calcium-activated channel subfamily M regulatory beta subunit 2 
KCNMB3	potassium calcium-activated channel subfamily M regulatory beta subunit 3 
KCNMB4	potassium calcium-activated channel subfamily M regulatory beta subunit 4 
KCNN1	potassium calcium-activated channel subfamily N member 1 
KCNN2	potassium calcium-activated channel subfamily N member 2 
KCNN3	potassium calcium-activated channel subfamily N member 3 
KCNN4	potassium calcium-activated channel subfamily N member 4 
KCNQ1	potassium voltage-gated channel subfamily Q member 1 
KCNQ2	potassium voltage-gated channel subfamily Q member 2 
KCNQ3	potassium voltage-gated channel subfamily Q member 3 
KCNQ4	potassium voltage-gated channel subfamily Q member 4 
KCNQ5	potassium voltage-gated channel subfamily Q member 5 
KCNT2	potassium sodium-activated channel subfamily T member 2 
KDM5D	lysine demethylase 5D 
KDR	kinase insert domain receptor 
KEAP1	kelch like ECH associated protein 1 
KEL	Kell metallo-endopeptidase (Kell blood group) 
KHSRP	KH-type splicing regulatory protein 
KIF11	kinesin family member 11 
KIF1A	kinesin family member 1A 
KIF2C	kinesin family member 2C 
KIF6	kinesin family member 6 
KISS1R	KISS1 receptor 
KIT	KIT proto-oncogene, receptor tyrosine kinase 
KL	klotho 
KLB	klotho beta 
KLC1	kinesin light chain 1 
KLC3	kinesin light chain 3 
KLK1	kallikrein 1 
KLK3	kallikrein related peptidase 3 
KLK6	kallikrein related peptidase 6 
KLK7	kallikrein related peptidase 7 
KLKB1	kallikrein B1 
KLRC1	killer cell lectin like receptor C1 
KLRD1	killer cell lectin like receptor D1 
KMT2E	lysine methyltransferase 2E 
KNG1	kininogen 1 
KRAS	KRAS proto-oncogene, GTPase 
KRT1	keratin 1 
KRT10	keratin 10 
KRT12	keratin 12 
KRT14	keratin 14 
KRT16	keratin 16 
KRT2	keratin 2 
KRT5	keratin 5 
KRT6A	keratin 6A 
KRT7	keratin 7 
KRT8	keratin 8 
KRT9	keratin 9 
KRTAP5-2	keratin associated protein 5-2 
KRTAP5-3	keratin associated protein 5-3 
KYAT1	kynurenine aminotransferase 1 
KYAT3	kynurenine aminotransferase 3 
KYNU	kynureninase 
L1CAM	L1 cell adhesion molecule 
L3HYPDH	trans-L-3-hydroxyproline dehydratase 
L3MBTL1	L3MBTL histone methyl-lysine binding protein 1 
LALBA	lactalbumin alpha 
LAMA1	laminin subunit alpha 1 
LAMA3	laminin subunit alpha 3 
LAMA5	laminin subunit alpha 5 
LAMB1	laminin subunit beta 1 
LAMC1	laminin subunit gamma 1 
LAP3	leucine aminopeptidase 3 
LARS1	leucyl-tRNA synthetase 1 
LARS2	leucyl-tRNA synthetase 2, mitochondrial 
LATS1	large tumor suppressor kinase 1 
LAYN	layilin 
LCK	LCK proto-oncogene, Src family tyrosine kinase 
LCMT1	leucine carboxyl methyltransferase 1 
LCMT2	leucine carboxyl methyltransferase 2 
LCN1	lipocalin 1 
LCN2	lipocalin 2 
LCN9	lipocalin 9 
LCT	lactase 
LCTL	lactase like 
LDHA	lactate dehydrogenase A 
LDHAL6A	lactate dehydrogenase A like 6A 
LDHAL6B	lactate dehydrogenase A like 6B 
LDHB	lactate dehydrogenase B 
LDHC	lactate dehydrogenase C 
LDLR	low density lipoprotein receptor 
LEF1	lymphoid enhancer binding factor 1 
LEP	leptin 
LEPR	leptin receptor 
LGALS1	galectin 1 
LGALS2	galectin 2 
LGALS3	galectin 3 
LGALS7	galectin 7 
LGALS9	galectin 9 
LGR5	leucine rich repeat containing G protein-coupled receptor 5 
LGSN	lengsin, lens protein with glutamine synthetase domain 
LHCGR	luteinizing hormone/choriogonadotropin receptor 
LIAS	lipoic acid synthetase 
LIG1	DNA ligase 1 
LIG3	DNA ligase 3 
LIMK1	LIM domain kinase 1 
LIMK2	LIM domain kinase 2 
LINC00251	long intergenic non-protein coding RNA 251 
LIPC	lipase C, hepatic type 
LIPF	lipase F, gastric type 
LIPT1	lipoyltransferase 1 
LKAAEAR1	LKAAEAR motif containing 1 
LMAN1	lectin, mannose binding 1 
LOX	lysyl oxidase 
LPA	lipoprotein(a) 
LPIN1	lipin 1 
LPL	lipoprotein lipase 
LRAT	lecithin retinol acyltransferase 
LRG1	leucine rich alpha-2-glycoprotein 1 
LRMDA	leucine rich melanocyte differentiation associated 
LRP1	LDL receptor related protein 1 
LRP2	LDL receptor related protein 2 
LRRC15	leucine rich repeat containing 15 
LRRK2	leucine rich repeat kinase 2 
LSM6	LSM6 homolog, U6 small nuclear RNA and mRNA degradation associated 
LSS	lanosterol synthase 
LST1	leukocyte specific transcript 1 
LTA	lymphotoxin alpha 
LTA4H	leukotriene A4 hydrolase 
LTB	lymphotoxin beta 
LTB4R	leukotriene B4 receptor 
LTB4R2	leukotriene B4 receptor 2 
LTC4S	leukotriene C4 synthase 
LTF	lactotransferrin 
LTK	leukocyte receptor tyrosine kinase 
LUM	lumican 
LY96	lymphocyte antigen 96 
LYN	LYN proto-oncogene, Src family tyrosine kinase 
LYZ	lysozyme 
M6PR	mannose-6-phosphate receptor, cation dependent 
MAD1L1	mitotic arrest deficient 1 like 1 
MAEA	macrophage erythroblast attacher 
MAFB	MAF bZIP transcription factor B 
MAFK	MAF bZIP transcription factor K 
MALAT1	metastasis associated lung adenocarcinoma transcript 1 
MAN1B1	mannosidase alpha class 1B member 1 
MAN2A1	mannosidase alpha class 2A member 1 
MAOA	monoamine oxidase A 
MAOB	monoamine oxidase B 
MAP1A	microtubule associated protein 1A 
MAP2	microtubule associated protein 2 
MAP2K1	mitogen-activated protein kinase kinase 1 
MAP2K2	mitogen-activated protein kinase kinase 2 
MAP2K3	mitogen-activated protein kinase kinase 3 
MAP2K4	mitogen-activated protein kinase kinase 4 
MAP2K5	mitogen-activated protein kinase kinase 5 
MAP2K6	mitogen-activated protein kinase kinase 6 
MAP3K1	mitogen-activated protein kinase kinase kinase 1 
MAP3K10	mitogen-activated protein kinase kinase kinase 10 
MAP3K11	mitogen-activated protein kinase kinase kinase 11 
MAP3K12	mitogen-activated protein kinase kinase kinase 12 
MAP3K13	mitogen-activated protein kinase kinase kinase 13 
MAP3K15	mitogen-activated protein kinase kinase kinase 15 
MAP3K19	mitogen-activated protein kinase kinase kinase 19 
MAP3K2	mitogen-activated protein kinase kinase kinase 2 
MAP3K20	mitogen-activated protein kinase kinase kinase 20 
MAP3K3	mitogen-activated protein kinase kinase kinase 3 
MAP3K4	mitogen-activated protein kinase kinase kinase 4 
MAP3K5	mitogen-activated protein kinase kinase kinase 5 
MAP3K6	mitogen-activated protein kinase kinase kinase 6 
MAP3K9	mitogen-activated protein kinase kinase kinase 9 
MAP4	microtubule associated protein 4 
MAP4K1	mitogen-activated protein kinase kinase kinase kinase 1 
MAP4K2	mitogen-activated protein kinase kinase kinase kinase 2 
MAP4K3	mitogen-activated protein kinase kinase kinase kinase 3 
MAP4K4	mitogen-activated protein kinase kinase kinase kinase 4 
MAP4K5	mitogen-activated protein kinase kinase kinase kinase 5 
MAPK1	mitogen-activated protein kinase 1 
MAPK10	mitogen-activated protein kinase 10 
MAPK11	mitogen-activated protein kinase 11 
MAPK12	mitogen-activated protein kinase 12 
MAPK13	mitogen-activated protein kinase 13 
MAPK14	mitogen-activated protein kinase 14 
MAPK15	mitogen-activated protein kinase 15 
MAPK3	mitogen-activated protein kinase 3 
MAPK4	mitogen-activated protein kinase 4 
MAPK6	mitogen-activated protein kinase 6 
MAPK7	mitogen-activated protein kinase 7 
MAPK8	mitogen-activated protein kinase 8 
MAPK8IP1	mitogen-activated protein kinase 8 interacting protein 1 
MAPK9	mitogen-activated protein kinase 9 
MAPKAPK2	MAPK activated protein kinase 2 
MAPKAPK3	MAPK activated protein kinase 3 
MAPKAPK5	MAPK activated protein kinase 5 
MAPT	microtubule associated protein tau 
MARCO	macrophage receptor with collagenous structure 
MARK1	microtubule affinity regulating kinase 1 
MARK2	microtubule affinity regulating kinase 2 
MARK3	microtubule affinity regulating kinase 3 
MARK4	microtubule affinity regulating kinase 4 
MARS1	methionyl-tRNA synthetase 1 
MARS2	methionyl-tRNA synthetase 2, mitochondrial 
MASP2	mannan binding lectin serine peptidase 2 
MAST1	microtubule associated serine/threonine kinase 1 
MAT1A	methionine adenosyltransferase 1A 
MAT2A	methionine adenosyltransferase 2A 
MAT2B	methionine adenosyltransferase 2B 
MATK	megakaryocyte-associated tyrosine kinase 
MB	myoglobin 
MBL2	mannose binding lectin 2 
MC1R	melanocortin 1 receptor 
MC2R	melanocortin 2 receptor 
MC3R	melanocortin 3 receptor 
MC4R	melanocortin 4 receptor 
MC5R	melanocortin 5 receptor 
MCAT	malonyl-CoA-acyl carrier protein transacylase 
MCCC1	methylcrotonoyl-CoA carboxylase 1 
MCCC2	methylcrotonoyl-CoA carboxylase 2 
MCFD2	multiple coagulation factor deficiency 2 
MCHR1	melanin concentrating hormone receptor 1 
MCL1	MCL1 apoptosis regulator, BCL2 family member 
MDGA2	MAM domain containing glycosylphosphatidylinositol anchor 2 
MDH1	malate dehydrogenase 1 
MDH2	malate dehydrogenase 2 
MDM2	MDM2 proto-oncogene 
MDM4	MDM4 regulator of p53 
ME1	malic enzyme 1 
ME2	malic enzyme 2 
ME3	malic enzyme 3 
MED1	mediator complex subunit 1 
MEG3	maternally expressed 3 
MELK	maternal embryonic leucine zipper kinase 
MERTK	MER proto-oncogene, tyrosine kinase 
MET	MET proto-oncogene, receptor tyrosine kinase 
METAP1	methionyl aminopeptidase 1 
METAP2	methionyl aminopeptidase 2 
METTL21A	methyltransferase like 21A 
MEX3C	mex-3 RNA binding family member C 
MGAM	maltase-glucoamylase 
MGAT1	alpha-1,3-mannosyl-glycoprotein 2-beta-N-acetylglucosaminyltransferase 
MGAT4A	alpha-1,3-mannosyl-glycoprotein 4-beta-N-acetylglucosaminyltransferase A 
MGMT	O-6-methylguanine-DNA methyltransferase 
MGP	matrix Gla protein 
MGST1	microsomal glutathione S-transferase 1 
MGST2	microsomal glutathione S-transferase 2 
MGST3	microsomal glutathione S-transferase 3 
MICB	MHC class I polypeptide-related sequence B 
MIEF2	mitochondrial elongation factor 2 
MIF	macrophage migration inhibitory factor 
MINK1	misshapen like kinase 1 
MIP	major intrinsic protein of lens fiber 
MIR27A	microRNA 27a 
MIR582	microRNA 582 
MKNK1	MAPK interacting serine/threonine kinase 1 
MKNK2	MAPK interacting serine/threonine kinase 2 
MLH1	mutL homolog 1 
MLLT3	MLLT3 super elongation complex subunit 
MLNR	motilin receptor 
MMAA	metabolism of cobalamin associated A 
MMAB	metabolism of cobalamin associated B 
MMACHC	metabolism of cobalamin associated C 
MME	membrane metalloendopeptidase 
MMP1	matrix metallopeptidase 1 
MMP10	matrix metallopeptidase 10 
MMP11	matrix metallopeptidase 11 
MMP12	matrix metallopeptidase 12 
MMP13	matrix metallopeptidase 13 
MMP14	matrix metallopeptidase 14 
MMP15	matrix metallopeptidase 15 
MMP16	matrix metallopeptidase 16 
MMP17	matrix metallopeptidase 17 
MMP19	matrix metallopeptidase 19 
MMP2	matrix metallopeptidase 2 
MMP20	matrix metallopeptidase 20 
MMP21	matrix metallopeptidase 21 
MMP23B	matrix metallopeptidase 23B 
MMP24	matrix metallopeptidase 24 
MMP25	matrix metallopeptidase 25 
MMP26	matrix metallopeptidase 26 
MMP27	matrix metallopeptidase 27 
MMP28	matrix metallopeptidase 28 
MMP3	matrix metallopeptidase 3 
MMP7	matrix metallopeptidase 7 
MMP8	matrix metallopeptidase 8 
MMP9	matrix metallopeptidase 9 
MMUT	methylmalonyl-CoA mutase 
MOB3B	MOB kinase activator 3B 
MOCOS	molybdenum cofactor sulfurase 
MPG	N-methylpurine DNA glycosylase 
MPL	MPL proto-oncogene, thrombopoietin receptor 
MPO	myeloperoxidase 
MR1	major histocompatibility complex, class I-related 
MRC1	mannose receptor C-type 1 
MRTFA	myocardin related transcription factor A 
MS4A1	membrane spanning 4-domains A1 
MS4A2	membrane spanning 4-domains A2 
MSANTD1	Myb/SANT DNA binding domain containing 1 
MSLN	mesothelin 
MSMO1	methylsterol monooxygenase 1 
MSRA	methionine sulfoxide reductase A 
MSRB1	methionine sulfoxide reductase B1 
MSRB2	methionine sulfoxide reductase B2 
MST1R	macrophage stimulating 1 receptor 
MSTN	myostatin 
MT-ATP6	mitochondrially encoded ATP synthase membrane subunit 6 
MT-CO1	mitochondrially encoded cytochrome c oxidase I 
MT-CO2	mitochondrially encoded cytochrome c oxidase II 
MT-CO3	mitochondrially encoded cytochrome c oxidase III 
MT-CYB	mitochondrially encoded cytochrome b 
MT-ND1	mitochondrially encoded NADH:ubiquinone oxidoreductase core subunit 1 
MT-ND2	mitochondrially encoded NADH:ubiquinone oxidoreductase core subunit 2 
MT-ND3	mitochondrially encoded NADH:ubiquinone oxidoreductase core subunit 3 
MT-ND4	mitochondrially encoded NADH:ubiquinone oxidoreductase core subunit 4 
MT-ND4L	mitochondrially encoded NADH:ubiquinone oxidoreductase core subunit 4L 
MT-ND5	mitochondrially encoded NADH:ubiquinone oxidoreductase core subunit 5 
MT-ND6	mitochondrially encoded NADH:ubiquinone oxidoreductase core subunit 6 
MT-RNR1	mitochondrially encoded 12S rRNA 
MT1A	metallothionein 1A 
MT1B	metallothionein 1B 
MT1DP	metallothionein 1D, pseudogene 
MT1E	metallothionein 1E 
MT1F	metallothionein 1F 
MT1G	metallothionein 1G 
MT1H	metallothionein 1H 
MT1HL1	metallothionein 1H like 1 
MT1L	metallothionein 1L, pseudogene 
MT1M	metallothionein 1M 
MT1X	metallothionein 1X 
MT2A	metallothionein 2A 
MT3	metallothionein 3 
MT4	metallothionein 4 
MTAP	methylthioadenosine phosphorylase 
MTF1	metal regulatory transcription factor 1 
MTFMT	mitochondrial methionyl-tRNA formyltransferase 
MTHFD1	methylenetetrahydrofolate dehydrogenase, cyclohydrolase and formyltetrahydrofolate synthetase 1 
MTHFD2	methylenetetrahydrofolate dehydrogenase (NADP+ dependent) 2, methenyltetrahydrofolate cyclohydrolase 
MTHFR	methylenetetrahydrofolate reductase 
MTNR1A	melatonin receptor 1A 
MTNR1B	melatonin receptor 1B 
MTOR	mechanistic target of rapamycin kinase 
MTR	5-methyltetrahydrofolate-homocysteine methyltransferase 
MTRF1L	mitochondrial translational release factor 1 like 
MTRR	5-methyltetrahydrofolate-homocysteine methyltransferase reductase 
MTTP	microsomal triglyceride transfer protein 
MUC1	mucin 1, cell surface associated 
MUC16	mucin 16, cell surface associated 
MUC2	mucin 2, oligomeric mucus/gel-forming 
MUSK	muscle associated receptor tyrosine kinase 
MUTYH	mutY DNA glycosylase 
MVK	mevalonate kinase 
MX1	MX dynamin like GTPase 1 
MYC	MYC proto-oncogene, bHLH transcription factor 
MYCN	MYCN proto-oncogene, bHLH transcription factor 
MYD88	MYD88 innate immune signal transduction adaptor 
MYH11	myosin heavy chain 11 
MYH14	myosin heavy chain 14 
MYH7	myosin heavy chain 7 
MYH9	myosin heavy chain 9 
MYL12A	myosin light chain 12A 
MYL6B	myosin light chain 6B 
MYLIP	myosin regulatory light chain interacting protein 
MYLK	myosin light chain kinase 
MYLK2	myosin light chain kinase 2 
MYLK3	myosin light chain kinase 3 
MYLK4	myosin light chain kinase family member 4 
MYO1E	myosin IE 
MYO1H	myosin IH 
MYO3A	myosin IIIA 
MYT1L	myelin transcription factor 1 like 
N6AMT1	N-6 adenine-specific DNA methyltransferase 1 
NAAA	N-acylethanolamine acid amidase 
NADSYN1	NAD synthetase 1 
NAE1	NEDD8 activating enzyme E1 subunit 1 
NAGA	alpha-N-acetylgalactosaminidase 
NAGK	N-acetylglucosamine kinase 
NAGLU	N-acetyl-alpha-glucosaminidase 
NAGPA	N-acetylglucosamine-1-phosphodiester alpha-N-acetylglucosaminidase 
NAGS	N-acetylglutamate synthase 
NALCN	sodium leak channel, non-selective 
NAMPT	nicotinamide phosphoribosyltransferase 
NAPEPLD	N-acyl phosphatidylethanolamine phospholipase D 
NARS1	asparaginyl-tRNA synthetase 1 
NARS2	asparaginyl-tRNA synthetase 2, mitochondrial 
NAT1	N-acetyltransferase 1 
NAT2	N-acetyltransferase 2 
NBEA	neurobeachin 
NCAM1	neural cell adhesion molecule 1 
NCAN	neurocan 
NCF1	neutrophil cytosolic factor 1 
NCF2	neutrophil cytosolic factor 2 
NCF4	neutrophil cytosolic factor 4 
NCOA1	nuclear receptor coactivator 1 
NCOA2	nuclear receptor coactivator 2 
NCOA5	nuclear receptor coactivator 5 
NCS1	neuronal calcium sensor 1 
NDST1	N-deacetylase and N-sulfotransferase 1 
NDUFA1	NADH:ubiquinone oxidoreductase subunit A1 
NDUFA10	NADH:ubiquinone oxidoreductase subunit A10 
NDUFA11	NADH:ubiquinone oxidoreductase subunit A11 
NDUFA12	NADH:ubiquinone oxidoreductase subunit A12 
NDUFA13	NADH:ubiquinone oxidoreductase subunit A13 
NDUFA2	NADH:ubiquinone oxidoreductase subunit A2 
NDUFA3	NADH:ubiquinone oxidoreductase subunit A3 
NDUFA4	NDUFA4 mitochondrial complex associated 
NDUFA4L2	NDUFA4 mitochondrial complex associated like 2 
NDUFA5	NADH:ubiquinone oxidoreductase subunit A5 
NDUFA6	NADH:ubiquinone oxidoreductase subunit A6 
NDUFA7	NADH:ubiquinone oxidoreductase subunit A7 
NDUFA8	NADH:ubiquinone oxidoreductase subunit A8 
NDUFA9	NADH:ubiquinone oxidoreductase subunit A9 
NDUFAB1	NADH:ubiquinone oxidoreductase subunit AB1 
NDUFB1	NADH:ubiquinone oxidoreductase subunit B1 
NDUFB10	NADH:ubiquinone oxidoreductase subunit B10 
NDUFB2	NADH:ubiquinone oxidoreductase subunit B2 
NDUFB3	NADH:ubiquinone oxidoreductase subunit B3 
NDUFB4	NADH:ubiquinone oxidoreductase subunit B4 
NDUFB5	NADH:ubiquinone oxidoreductase subunit B5 
NDUFB6	NADH:ubiquinone oxidoreductase subunit B6 
NDUFB7	NADH:ubiquinone oxidoreductase subunit B7 
NDUFB8	NADH:ubiquinone oxidoreductase subunit B8 
NDUFB9	NADH:ubiquinone oxidoreductase subunit B9 
NDUFC1	NADH:ubiquinone oxidoreductase subunit C1 
NDUFC2	NADH:ubiquinone oxidoreductase subunit C2 
NDUFS1	NADH:ubiquinone oxidoreductase core subunit S1 
NDUFS2	NADH:ubiquinone oxidoreductase core subunit S2 
NDUFS3	NADH:ubiquinone oxidoreductase core subunit S3 
NDUFS4	NADH:ubiquinone oxidoreductase subunit S4 
NDUFS5	NADH:ubiquinone oxidoreductase subunit S5 
NDUFS6	NADH:ubiquinone oxidoreductase subunit S6 
NDUFS7	NADH:ubiquinone oxidoreductase core subunit S7 
NDUFS8	NADH:ubiquinone oxidoreductase core subunit S8 
NDUFV1	NADH:ubiquinone oxidoreductase core subunit V1 
NDUFV2	NADH:ubiquinone oxidoreductase core subunit V2 
NDUFV3	NADH:ubiquinone oxidoreductase subunit V3 
NECTIN4	nectin cell adhesion molecule 4 
NEDD4	NEDD4 E3 ubiquitin protein ligase 
NEDD4L	NEDD4 like E3 ubiquitin protein ligase 
NEIL1	nei like DNA glycosylase 1 
NEIL2	nei like DNA glycosylase 2 
NEK1	NIMA related kinase 1 
NEK11	NIMA related kinase 11 
NEK2	NIMA related kinase 2 
NEK3	NIMA related kinase 3 
NEK4	NIMA related kinase 4 
NEK5	NIMA related kinase 5 
NEK9	NIMA related kinase 9 
NELFCD	negative elongation factor complex member C/D 
NEU1	neuraminidase 1 
NEU2	neuraminidase 2 
NEUROD1	neuronal differentiation 1 
NFATC1	nuclear factor of activated T cells 1 
NFATC2	nuclear factor of activated T cells 2 
NFE2L1	nuclear factor, erythroid 2 like 1 
NFIB	nuclear factor I B 
NFKB1	nuclear factor kappa B subunit 1 
NFKB2	nuclear factor kappa B subunit 2 
NFKBIA	NFKB inhibitor alpha 
NFS1	NFS1 cysteine desulfurase 
NGF	nerve growth factor 
NID1	nidogen 1 
NIM1K	NIM1 serine/threonine protein kinase 
NIP7	nucleolar pre-rRNA processing protein NIP7 
NISCH	nischarin 
NME1	NME/NM23 nucleoside diphosphate kinase 1 
NME2	NME/NM23 nucleoside diphosphate kinase 2 
NMNAT1	nicotinamide nucleotide adenylyltransferase 1 
NMNAT3	nicotinamide nucleotide adenylyltransferase 3 
NMRAL1	NmrA like redox sensor 1 
NMT1	N-myristoyltransferase 1 
NMT2	N-myristoyltransferase 2 
NNMT	nicotinamide N-methyltransferase 
NNT	nicotinamide nucleotide transhydrogenase 
NOD2	nucleotide binding oligomerization domain containing 2 
NOLC1	nucleolar and coiled-body phosphoprotein 1 
NOMO1	NODAL modulator 1 
NOS1	nitric oxide synthase 1 
NOS1AP	nitric oxide synthase 1 adaptor protein 
NOS2	nitric oxide synthase 2 
NOS3	nitric oxide synthase 3 
NOTCH4	notch receptor 4 
NOX1	NADPH oxidase 1 
NOXO1	NADPH oxidase organizer 1 
NPC1L1	NPC1 like intracellular cholesterol transporter 1 
NPEPPS	aminopeptidase puromycin sensitive 
NPHS1	NPHS1 adhesion molecule, nephrin 
NPIPB8	nuclear pore complex interacting protein family member B8 
NPM1	nucleophosmin 1 
NPPA	natriuretic peptide A 
NPPA-AS1	NPPA antisense RNA 1
NPPB	natriuretic peptide B 
NPR1	natriuretic peptide receptor 1 
NPR2	natriuretic peptide receptor 2 
NPR3	natriuretic peptide receptor 3 
NPSR1	neuropeptide S receptor 1 
NPY	neuropeptide Y 
NPY1R	neuropeptide Y receptor Y1 
NPY2R	neuropeptide Y receptor Y2 
NPY4R	neuropeptide Y receptor Y4 
NPY5R	neuropeptide Y receptor Y5 
NQO1	NAD(P)H quinone dehydrogenase 1 
NQO2	N-ribosyldihydronicotinamide:quinone reductase 2 
NR0B1	nuclear receptor subfamily 0 group B member 1 
NR1D1	nuclear receptor subfamily 1 group D member 1 
NR1D2	nuclear receptor subfamily 1 group D member 2 
NR1H2	nuclear receptor subfamily 1 group H member 2 
NR1H3	nuclear receptor subfamily 1 group H member 3 
NR1H4	nuclear receptor subfamily 1 group H member 4 
NR1I2	nuclear receptor subfamily 1 group I member 2 
NR1I3	nuclear receptor subfamily 1 group I member 3 
NR2F1	nuclear receptor subfamily 2 group F member 1 
NR3C1	nuclear receptor subfamily 3 group C member 1 
NR3C2	nuclear receptor subfamily 3 group C member 2 
NR4A3	nuclear receptor subfamily 4 group A member 3 
NR5A1	nuclear receptor subfamily 5 group A member 1 
NRAS	NRAS proto-oncogene, GTPase 
NRG1	neuregulin 1 
NRG3	neuregulin 3 
NRIP1	nuclear receptor interacting protein 1 
NRP1	neuropilin 1 
NRP2	neuropilin 2 
NRXN1	neurexin 1 
NSDHL	NAD(P) dependent steroid dehydrogenase-like 
NSF	N-ethylmaleimide sensitive factor, vesicle fusing ATPase 
NT5C	5', 3'-nucleotidase, cytosolic 
NT5C1A	5'-nucleotidase, cytosolic IA 
NT5C2	5'-nucleotidase, cytosolic II 
NT5C3A	5'-nucleotidase, cytosolic IIIA 
NT5E	5'-nucleotidase ecto 
NT5M	5',3'-nucleotidase, mitochondrial 
NTNG1	netrin G1 
NTRK1	neurotrophic receptor tyrosine kinase 1 
NTRK2	neurotrophic receptor tyrosine kinase 2 
NTRK3	neurotrophic receptor tyrosine kinase 3 
NTSR2	neurotensin receptor 2 
NUAK1	NUAK family kinase 1 
NUAK2	NUAK family kinase 2 
NUBPL	nucleotide binding protein like 
NUCB1	nucleobindin 1 
NUCB2	nucleobindin 2 
NUDC	nuclear distribution C, dynein complex regulator 
NUDT15	nudix hydrolase 15 
NUDT9	nudix hydrolase 9 
NUMA1	nuclear mitotic apparatus protein 1 
OAS1	2'-5'-oligoadenylate synthetase 1 
OASL	2'-5'-oligoadenylate synthetase like 
OAT	ornithine aminotransferase 
OAZ1	ornithine decarboxylase antizyme 1 
OAZ2	ornithine decarboxylase antizyme 2 
OAZ3	ornithine decarboxylase antizyme 3 
OBP2A	odorant binding protein 2A 
OCRL	OCRL inositol polyphosphate-5-phosphatase 
ODC1	ornithine decarboxylase 1 
OGA	O-GlcNAcase 
OGDH	oxoglutarate dehydrogenase 
OGFOD1	2-oxoglutarate and iron dependent oxygenase domain containing 1 
OGFOD2	2-oxoglutarate and iron dependent oxygenase domain containing 2 
OPCML	opioid binding protein/cell adhesion molecule like 
OPLAH	5-oxoprolinase, ATP-hydrolysing 
OPRD1	opioid receptor delta 1 
OPRK1	opioid receptor kappa 1 
OPRL1	opioid related nociceptin receptor 1 
OPRM1	opioid receptor mu 1 
OR52E2	olfactory receptor family 52 subfamily E member 2 
OR52J2P	olfactory receptor family 52 subfamily J member 2 pseudogene 
OR52J3	olfactory receptor family 52 subfamily J member 3 
ORM1	orosomucoid 1 
ORM2	orosomucoid 2 
OTC	ornithine carbamoyltransferase 
OTOS	otospiralin 
OXCT1	3-oxoacid CoA-transferase 1 
OXCT2	3-oxoacid CoA-transferase 2 
OXSR1	oxidative stress responsive kinase 1 
OXT	oxytocin/neurophysin I prepropeptide 
OXTR	oxytocin receptor 
P2RX4	purinergic receptor P2X 4 
P2RX7	purinergic receptor P2X 7 
P2RY1	purinergic receptor P2Y1 
P2RY11	purinergic receptor P2Y11 
P2RY12	purinergic receptor P2Y12 
P2RY2	purinergic receptor P2Y2 
P3H1	prolyl 3-hydroxylase 1 
P3H2	prolyl 3-hydroxylase 2 
P3H3	prolyl 3-hydroxylase 3 
P4HA1	prolyl 4-hydroxylase subunit alpha 1 
P4HA2	prolyl 4-hydroxylase subunit alpha 2 
P4HB	prolyl 4-hydroxylase subunit beta 
P4HTM	prolyl 4-hydroxylase, transmembrane 
PACSIN2	protein kinase C and casein kinase substrate in neurons 2 
PADI1	peptidyl arginine deiminase 1 
PADI2	peptidyl arginine deiminase 2 
PADI3	peptidyl arginine deiminase 3 
PADI4	peptidyl arginine deiminase 4 
PADI6	peptidyl arginine deiminase 6 
PAEP	progestagen associated endometrial protein 
PAFAH1B3	platelet activating factor acetylhydrolase 1b catalytic subunit 3 
PAH	phenylalanine hydroxylase 
PAICS	phosphoribosylaminoimidazole carboxylase and phosphoribosylaminoimidazolesuccinocarboxamide synthase 
PAK1	p21 (RAC1) activated kinase 1 
PAK2	p21 (RAC1) activated kinase 2 
PAK3	p21 (RAC1) activated kinase 3 
PAK4	p21 (RAC1) activated kinase 4 
PAK5	p21 (RAC1) activated kinase 5 
PAK6	p21 (RAC1) activated kinase 6 
PAM	peptidylglycine alpha-amidating monooxygenase 
PANX1	pannexin 1 
PAPLN	papilin, proteoglycan like sulfated glycoprotein 
PAPOLA	poly(A) polymerase alpha 
PAPPA	pappalysin 1 
PAPSS1	3'-phosphoadenosine 5'-phosphosulfate synthase 1 
PARD3B	par-3 family cell polarity regulator beta 
PARK7	Parkinsonism associated deglycase 
PARP1	poly(ADP-ribose) polymerase 1 
PARP11	poly(ADP-ribose) polymerase family member 11 
PARP15	poly(ADP-ribose) polymerase family member 15 
PARP2	poly(ADP-ribose) polymerase 2 
PARP3	poly(ADP-ribose) polymerase family member 3 
PARS2	prolyl-tRNA synthetase 2, mitochondrial 
PAX4	paired box 4 
PC	pyruvate carboxylase 
PCBD1	pterin-4 alpha-carbinolamine dehydratase 1 
PCCA	propionyl-CoA carboxylase subunit alpha 
PCCB	propionyl-CoA carboxylase subunit beta 
PCDH19	protocadherin 19 
PCK1	phosphoenolpyruvate carboxykinase 1 
PCK2	phosphoenolpyruvate carboxykinase 2, mitochondrial 
PCMT1	protein-L-isoaspartate (D-aspartate) O-methyltransferase 
PCNA	proliferating cell nuclear antigen 
PCSK1	proprotein convertase subtilisin/kexin type 1 
PCSK2	proprotein convertase subtilisin/kexin type 2 
PCSK9	proprotein convertase subtilisin/kexin type 9 
PCTP	phosphatidylcholine transfer protein 
PCYT1A	phosphate cytidylyltransferase 1, choline, alpha 
PCYT1B	phosphate cytidylyltransferase 1, choline, beta 
PCYT2	phosphate cytidylyltransferase 2, ethanolamine 
PDCD1	programmed cell death 1 
PDCD6	programmed cell death 6 
PDE10A	phosphodiesterase 10A 
PDE11A	phosphodiesterase 11A 
PDE1A	phosphodiesterase 1A 
PDE1B	phosphodiesterase 1B 
PDE1C	phosphodiesterase 1C 
PDE2A	phosphodiesterase 2A 
PDE3A	phosphodiesterase 3A 
PDE3B	phosphodiesterase 3B 
PDE4A	phosphodiesterase 4A 
PDE4B	phosphodiesterase 4B 
PDE4C	phosphodiesterase 4C 
PDE4D	phosphodiesterase 4D 
PDE5A	phosphodiesterase 5A 
PDE6A	phosphodiesterase 6A 
PDE6B	phosphodiesterase 6B 
PDE6C	phosphodiesterase 6C 
PDE6G	phosphodiesterase 6G 
PDE6H	phosphodiesterase 6H 
PDE7A	phosphodiesterase 7A 
PDE7B	phosphodiesterase 7B 
PDE8A	phosphodiesterase 8A 
PDE8B	phosphodiesterase 8B 
PDE9A	phosphodiesterase 9A 
PDF	peptide deformylase, mitochondrial 
PDGFB	platelet derived growth factor subunit B 
PDGFD	platelet derived growth factor D 
PDGFRA	platelet derived growth factor receptor alpha 
PDGFRB	platelet derived growth factor receptor beta 
PDHA1	pyruvate dehydrogenase E1 alpha 1 subunit 
PDHA2	pyruvate dehydrogenase E1 alpha 2 subunit 
PDHB	pyruvate dehydrogenase E1 beta subunit 
PDIA2	protein disulfide isomerase family A member 2 
PDIA3	protein disulfide isomerase family A member 3 
PDK1	pyruvate dehydrogenase kinase 1 
PDK2	pyruvate dehydrogenase kinase 2 
PDK3	pyruvate dehydrogenase kinase 3 
PDK4	pyruvate dehydrogenase kinase 4 
PDPK1	3-phosphoinositide dependent protein kinase 1 
PDXDC1	pyridoxal dependent decarboxylase domain containing 1 
PDXK	pyridoxal kinase 
PDXP	pyridoxal phosphatase 
PDYN	prodynorphin 
PEAR1	platelet endothelial aggregation receptor 1 
PEBP1	phosphatidylethanolamine binding protein 1 
PEBP4	phosphatidylethanolamine binding protein 4 
PECR	peroxisomal trans-2-enoyl-CoA reductase 
PEF1	penta-EF-hand domain containing 1 
PERP	p53 apoptosis effector related to PMP22 
PF4	platelet factor 4 
PFAS	phosphoribosylformylglycinamidine synthase 
PFKFB1	6-phosphofructo-2-kinase/fructose-2,6-biphosphatase 1 
PFKFB4	6-phosphofructo-2-kinase/fructose-2,6-biphosphatase 4 
PFN1	profilin 1 
PFN2	profilin 2 
PGA5	pepsinogen A5 
PGAM1	phosphoglycerate mutase 1 
PGAM2	phosphoglycerate mutase 2 
PGD	phosphogluconate dehydrogenase 
PGF	placental growth factor 
PGGT1B	protein geranylgeranyltransferase type I subunit beta 
PGK1	phosphoglycerate kinase 1 
PGK2	phosphoglycerate kinase 2 
PGLYRP2	peptidoglycan recognition protein 2 
PGLYRP3	peptidoglycan recognition protein 3 
PGLYRP4	peptidoglycan recognition protein 4 
PGM1	phosphoglucomutase 1 
PGR	progesterone receptor 
PGRMC1	progesterone receptor membrane component 1 
PHB	prohibitin 
PHB2	prohibitin 2 
PHGDH	phosphoglycerate dehydrogenase 
PHKG1	phosphorylase kinase catalytic subunit gamma 1 
PHOSPHO1	phosphoethanolamine/phosphocholine phosphatase 1 
PHYH	phytanoyl-CoA 2-hydroxylase 
PHYKPL	5-phosphohydroxy-L-lysine phospho-lyase 
PI4K2B	phosphatidylinositol 4-kinase type 2 beta 
PI4KB	phosphatidylinositol 4-kinase beta 
PICALM	phosphatidylinositol binding clathrin assembly protein 
PICK1	protein interacting with PRKCA 1 
PIGB	phosphatidylinositol glycan anchor biosynthesis class B 
PIGM	phosphatidylinositol glycan anchor biosynthesis class M 
PIK3C2B	phosphatidylinositol-4-phosphate 3-kinase catalytic subunit type 2 beta 
PIK3C2G	phosphatidylinositol-4-phosphate 3-kinase catalytic subunit type 2 gamma 
PIK3C3	phosphatidylinositol 3-kinase catalytic subunit type 3 
PIK3CA	phosphatidylinositol-4,5-bisphosphate 3-kinase catalytic subunit alpha 
PIK3CB	phosphatidylinositol-4,5-bisphosphate 3-kinase catalytic subunit beta 
PIK3CD	phosphatidylinositol-4,5-bisphosphate 3-kinase catalytic subunit delta 
PIK3CG	phosphatidylinositol-4,5-bisphosphate 3-kinase catalytic subunit gamma 
PIK3R1	phosphoinositide-3-kinase regulatory subunit 1 
PIK3R2	phosphoinositide-3-kinase regulatory subunit 2 
PIK3R3	phosphoinositide-3-kinase regulatory subunit 3 
PIM1	Pim-1 proto-oncogene, serine/threonine kinase 
PIM3	Pim-3 proto-oncogene, serine/threonine kinase 
PIN1	peptidylprolyl cis/trans isomerase, NIMA-interacting 1 
PIP4K2B	phosphatidylinositol-5-phosphate 4-kinase type 2 beta 
PIP4K2C	phosphatidylinositol-5-phosphate 4-kinase type 2 gamma 
PIP5K1C	phosphatidylinositol-4-phosphate 5-kinase type 1 gamma 
PIPOX	pipecolic acid and sarcosine oxidase 
PISD	phosphatidylserine decarboxylase 
PITPNA	phosphatidylinositol transfer protein alpha 
PKD1L3	polycystin 1 like 3, transient receptor potential channel interacting 
PKD2	polycystin 2, transient receptor potential cation channel 
PKD2L1	polycystin 2 like 1, transient receptor potential cation channel 
PKIA	cAMP-dependent protein kinase inhibitor alpha 
PKLR	pyruvate kinase L/R 
PKM	pyruvate kinase M1/2 
PKMYT1	protein kinase, membrane associated tyrosine/threonine 1 
PKN1	protein kinase N1 
PKN2	protein kinase N2 
PLA2G10	phospholipase A2 group X 
PLA2G1B	phospholipase A2 group IB 
PLA2G2A	phospholipase A2 group IIA 
PLA2G2D	phospholipase A2 group IID 
PLA2G2E	phospholipase A2 group IIE 
PLA2G4A	phospholipase A2 group IVA 
PLA2G6	phospholipase A2 group VI 
PLA2G7	phospholipase A2 group VII 
PLAT	plasminogen activator, tissue type 
PLAU	plasminogen activator, urokinase 
PLAUR	plasminogen activator, urokinase receptor 
PLCB1	phospholipase C beta 1 
PLCD1	phospholipase C delta 1 
PLCD3	phospholipase C delta 3 
PLCG1	phospholipase C gamma 1 
PLCL1	phospholipase C like 1 (inactive) 
PLD1	phospholipase D1 
PLD2	phospholipase D2 
PLEKHA1	pleckstrin homology domain containing A1 
PLEKHA4	pleckstrin homology domain containing A4 
PLEKHH2	pleckstrin homology, MyTH4 and FERM domain containing H2 
PLG	plasminogen 
PLIN1	perilipin 1 
PLIN3	perilipin 3 
PLK1	polo like kinase 1 
PLK2	polo like kinase 2 
PLK3	polo like kinase 3 
PLK4	polo like kinase 4 
PLOD1	procollagen-lysine,2-oxoglutarate 5-dioxygenase 1 
PLOD2	procollagen-lysine,2-oxoglutarate 5-dioxygenase 2 
PLOD3	procollagen-lysine,2-oxoglutarate 5-dioxygenase 3 
PLPBP	pyridoxal phosphate binding protein 
PLTP	phospholipid transfer protein 
PMCH	pro-melanin concentrating hormone 
PML	promyelocytic leukemia 
PMP2	peripheral myelin protein 2 
PMS2	PMS1 homolog 2, mismatch repair system component 
PNLIP	pancreatic lipase 
PNLIPRP2	pancreatic lipase related protein 2 (gene/pseudogene) 
PNMT	phenylethanolamine N-methyltransferase 
PNP	purine nucleoside phosphorylase 
PNPLA3	patatin like phospholipase domain containing 3 
PNPO	pyridoxamine 5'-phosphate oxidase 
POLA1	DNA polymerase alpha 1, catalytic subunit 
POLA2	DNA polymerase alpha 2, accessory subunit 
POLB	DNA polymerase beta 
POLE	DNA polymerase epsilon, catalytic subunit 
POLE2	DNA polymerase epsilon 2, accessory subunit 
POLE3	DNA polymerase epsilon 3, accessory subunit 
POLE4	DNA polymerase epsilon 4, accessory subunit 
POLG	DNA polymerase gamma, catalytic subunit 
POLK	DNA polymerase kappa 
POLR2A	RNA polymerase II subunit A 
POLR3G	RNA polymerase III subunit G 
POMC	proopiomelanocortin 
PON1	paraoxonase 1 
PON2	paraoxonase 2 
PON3	paraoxonase 3 
POR	cytochrome p450 oxidoreductase 
POU2F1	POU class 2 homeobox 1 
POU2F2	POU class 2 homeobox 2 
POU5F1	POU class 5 homeobox 1 
PPA2	inorganic pyrophosphatase 2 
PPARA	peroxisome proliferator activated receptor alpha 
PPARD	peroxisome proliferator activated receptor delta 
PPARG	peroxisome proliferator activated receptor gamma 
PPAT	phosphoribosyl pyrophosphate amidotransferase 
PPBP	pro-platelet basic protein 
PPCDC	phosphopantothenoylcysteine decarboxylase 
PPIA	peptidylprolyl isomerase A 
PPIB	peptidylprolyl isomerase B 
PPIC	peptidylprolyl isomerase C 
PPIF	peptidylprolyl isomerase F 
PPIG	peptidylprolyl isomerase G 
PPIH	peptidylprolyl isomerase H 
PPOX	protoporphyrinogen oxidase 
PPP1CA	protein phosphatase 1 catalytic subunit alpha 
PPP1CC	protein phosphatase 1 catalytic subunit gamma 
PPP1R13L	protein phosphatase 1 regulatory subunit 13 like 
PPP2CA	protein phosphatase 2 catalytic subunit alpha 
PPP2CB	protein phosphatase 2 catalytic subunit beta 
PPP2R1A	protein phosphatase 2 scaffold subunit Aalpha 
PPP2R2A	protein phosphatase 2 regulatory subunit Balpha 
PPP2R5C	protein phosphatase 2 regulatory subunit B'gamma 
PPP2R5D	protein phosphatase 2 regulatory subunit B'delta 
PPP3CA	protein phosphatase 3 catalytic subunit alpha 
PPP3R1	protein phosphatase 3 regulatory subunit B, alpha 
PPP3R2	protein phosphatase 3 regulatory subunit B, beta 
PPP5C	protein phosphatase 5 catalytic subunit 
PPT1	palmitoyl-protein thioesterase 1 
PRCP	prolylcarboxypeptidase 
PRDX1	peroxiredoxin 1 
PRDX2	peroxiredoxin 2 
PRDX4	peroxiredoxin 4 
PRDX5	peroxiredoxin 5 
PRDX6	peroxiredoxin 6 
PREP	prolyl endopeptidase 
PRF1	perforin 1 
PRG2	proteoglycan 2, pro eosinophil major basic protein 
PRKAA1	protein kinase AMP-activated catalytic subunit alpha 1 
PRKAA2	protein kinase AMP-activated catalytic subunit alpha 2 
PRKAB1	protein kinase AMP-activated non-catalytic subunit beta 1 
PRKAB2	protein kinase AMP-activated non-catalytic subunit beta 2 
PRKACA	protein kinase cAMP-activated catalytic subunit alpha 
PRKACB	protein kinase cAMP-activated catalytic subunit beta 
PRKAG1	protein kinase AMP-activated non-catalytic subunit gamma 1 
PRKAG2	protein kinase AMP-activated non-catalytic subunit gamma 2 
PRKAG3	protein kinase AMP-activated non-catalytic subunit gamma 3 
PRKAR1A	protein kinase cAMP-dependent type I regulatory subunit alpha 
PRKAR2A	protein kinase cAMP-dependent type II regulatory subunit alpha 
PRKAR2B	protein kinase cAMP-dependent type II regulatory subunit beta 
PRKCA	protein kinase C alpha 
PRKCB	protein kinase C beta 
PRKCD	protein kinase C delta 
PRKCE	protein kinase C epsilon 
PRKCG	protein kinase C gamma 
PRKCI	protein kinase C iota 
PRKCQ	protein kinase C theta 
PRKCZ	protein kinase C zeta 
PRKD1	protein kinase D1 
PRKDC	protein kinase, DNA-activated, catalytic subunit 
PRKG2	protein kinase cGMP-dependent 2 
PRKN	parkin RBR E3 ubiquitin protein ligase 
PRLR	prolactin receptor 
PRMT1	protein arginine methyltransferase 1 
PRMT3	protein arginine methyltransferase 3 
PRNP	prion protein 
PROC	protein C, inactivator of coagulation factors Va and VIIIa 
PROCR	protein C receptor 
PRODH	proline dehydrogenase 1 
PRORP	protein only RNase P catalytic subunit 
PROS1	protein S 
PROX1	prospero homeobox 1 
PROZ	protein Z, vitamin K dependent plasma glycoprotein 
PRPF31	pre-mRNA processing factor 31 
PRPF4B	pre-mRNA processing factor 4B 
PRRC2A	proline rich coiled-coil 2A 
PRSS1	serine protease 1 
PRSS2	serine protease 2 
PRSS3	serine protease 3 
PRSS53	serine protease 53 
PRSS8	serine protease 8 
PRTN3	proteinase 3 
PSAP	prosaposin 
PSAT1	phosphoserine aminotransferase 1 
PSENEN	presenilin enhancer, gamma-secretase subunit 
PSG5	pregnancy specific beta-1-glycoprotein 5 
PSMA1	proteasome 20S subunit alpha 1 
PSMA2	proteasome 20S subunit alpha 2 
PSMA3	proteasome 20S subunit alpha 3 
PSMA4	proteasome 20S subunit alpha 4 
PSMA5	proteasome 20S subunit alpha 5 
PSMA6	proteasome 20S subunit alpha 6 
PSMA7	proteasome 20S subunit alpha 7 
PSMB1	proteasome 20S subunit beta 1 
PSMB10	proteasome 20S subunit beta 10 
PSMB2	proteasome 20S subunit beta 2 
PSMB3	proteasome 20S subunit beta 3 
PSMB4	proteasome 20S subunit beta 4 
PSMB5	proteasome 20S subunit beta 5 
PSMB6	proteasome 20S subunit beta 6 
PSMB7	proteasome 20S subunit beta 7 
PSMB8	proteasome 20S subunit beta 8 
PSMB9	proteasome 20S subunit beta 9 
PSMC3	proteasome 26S subunit, ATPase 3 
PSME1	proteasome activator subunit 1 
PSORS1C1	psoriasis susceptibility 1 candidate 1 
PSORS1C3	psoriasis susceptibility 1 candidate 3 
PSPH	phosphoserine phosphatase 
PTAFR	platelet activating factor receptor 
PTDSS1	phosphatidylserine synthase 1 
PTDSS2	phosphatidylserine synthase 2 
PTEN	phosphatase and tensin homolog 
PTGDR	prostaglandin D2 receptor 
PTGDR2	prostaglandin D2 receptor 2 
PTGER1	prostaglandin E receptor 1 
PTGER2	prostaglandin E receptor 2 
PTGER3	prostaglandin E receptor 3 
PTGER4	prostaglandin E receptor 4 
PTGES	prostaglandin E synthase 
PTGES3	prostaglandin E synthase 3 
PTGFR	prostaglandin F receptor 
PTGIR	prostaglandin I2 receptor 
PTGIS	prostaglandin I2 synthase 
PTGR1	prostaglandin reductase 1 
PTGR2	prostaglandin reductase 2 
PTGS1	prostaglandin-endoperoxide synthase 1 
PTGS2	prostaglandin-endoperoxide synthase 2 
PTH	parathyroid hormone 
PTH1R	parathyroid hormone 1 receptor 
PTH2R	parathyroid hormone 2 receptor 
PTK2	protein tyrosine kinase 2 
PTK2B	protein tyrosine kinase 2 beta 
PTK6	protein tyrosine kinase 6 
PTPN1	protein tyrosine phosphatase non-receptor type 1 
PTPN11	protein tyrosine phosphatase non-receptor type 11 
PTPN4	protein tyrosine phosphatase non-receptor type 4 
PTPRB	protein tyrosine phosphatase receptor type B 
PTPRC	protein tyrosine phosphatase receptor type C 
PTPRD	protein tyrosine phosphatase receptor type D 
PTPRE	protein tyrosine phosphatase receptor type E 
PTPRM	protein tyrosine phosphatase receptor type M 
PTPRS	protein tyrosine phosphatase receptor type S 
PTS	6-pyruvoyltetrahydropterin synthase 
PURA	purine rich element binding protein A 
PVALB	parvalbumin 
PVR	PVR cell adhesion molecule 
PYCR1	pyrroline-5-carboxylate reductase 1 
PYCR2	pyrroline-5-carboxylate reductase 2 
PYCR3	pyrroline-5-carboxylate reductase 3 
PYGB	glycogen phosphorylase B 
PYGL	glycogen phosphorylase L 
PYGM	glycogen phosphorylase, muscle associated 
PZP	PZP alpha-2-macroglobulin like 
QARS1	glutaminyl-tRNA synthetase 1 
QDPR	quinoid dihydropteridine reductase 
QPCT	glutaminyl-peptide cyclotransferase 
QPRT	quinolinate phosphoribosyltransferase 
RAB11A	RAB11A, member RAS oncogene family 
RAB27A	RAB27A, member RAS oncogene family 
RAB5A	RAB5A, member RAS oncogene family 
RAB7A	RAB7A, member RAS oncogene family 
RAB8B	RAB8B, member RAS oncogene family 
RAB9A	RAB9A, member RAS oncogene family 
RABEP1	rabaptin, RAB GTPase binding effector protein 1 
RABGGTA	Rab geranylgeranyltransferase subunit alpha 
RABGGTB	Rab geranylgeranyltransferase subunit beta 
RAC1	Rac family small GTPase 1 
RAC2	Rac family small GTPase 2 
RACK1	receptor for activated C kinase 1 
RAD51	RAD51 recombinase 
RAD52	RAD52 homolog, DNA repair protein 
RAF1	Raf-1 proto-oncogene, serine/threonine kinase 
RALA	RAS like proto-oncogene A 
RALBP1	ralA binding protein 1 
RAMP1	receptor activity modifying protein 1 
RAMP2	receptor activity modifying protein 2 
RAMP3	receptor activity modifying protein 3 
RAN	RAN, member RAS oncogene family 
RANBP1	RAN binding protein 1 
RAP2A	RAP2A, member of RAS oncogene family 
RAPGEF5	Rap guanine nucleotide exchange factor 5 
RARA	retinoic acid receptor alpha 
RARB	retinoic acid receptor beta 
RARG	retinoic acid receptor gamma 
RARRES1	retinoic acid receptor responder 1 
RARS1	arginyl-tRNA synthetase 1 
RASSF1	Ras association domain family member 1 
RB1	RB transcriptional corepressor 1 
RBFOX1	RNA binding fox-1 homolog 1 
RBMS3	RNA binding motif single stranded interacting protein 3 
RBP1	retinol binding protein 1 
RBP2	retinol binding protein 2 
RBP3	retinol binding protein 3 
RBP4	retinol binding protein 4 
RBP5	retinol binding protein 5 
RBP7	retinol binding protein 7 
RBX1	ring-box 1 
RCAN1	regulator of calcineurin 1 
RCVRN	recoverin 
RDH11	retinol dehydrogenase 11 
RDH12	retinol dehydrogenase 12 
RDH13	retinol dehydrogenase 13 
RDH14	retinol dehydrogenase 14 
RDH5	retinol dehydrogenase 5 
RDH8	retinol dehydrogenase 8 
RDX	radixin 
REEP5	receptor accessory protein 5 
REG1A	regenerating family member 1 alpha 
RELA	RELA proto-oncogene, NF-kB subunit 
REN	renin 
RENBP	renin binding protein 
RET	ret proto-oncogene 
RETSAT	retinol saturase 
REV1	REV1 DNA directed polymerase 
REV3L	REV3 like, DNA directed polymerase zeta catalytic subunit 
RFK	riboflavin kinase 
RGN	regucalcin 
RGS17	regulator of G protein signaling 17 
RGS19	regulator of G protein signaling 19 
RGS2	regulator of G protein signaling 2 
RGS4	regulator of G protein signaling 4 
RGS5	regulator of G protein signaling 5 
RHBDF2	rhomboid 5 homolog 2 
RHCG	Rh family C glycoprotein 
RHD	Rh blood group D antigen 
RHEB	Ras homolog, mTORC1 binding 
RHO	rhodopsin 
RHOA	ras homolog family member A 
RHOB	ras homolog family member B 
RIC3	RIC3 acetylcholine receptor chaperone 
RIDA	reactive intermediate imine deaminase A homolog 
RIOK1	RIO kinase 1 
RIOK2	RIO kinase 2 
RIOK3	RIO kinase 3 
RIPK1	receptor interacting serine/threonine kinase 1 
RIPK2	receptor interacting serine/threonine kinase 2 
RIPK4	receptor interacting serine/threonine kinase 4 
RIPOR2	RHO family interacting cell polarization regulator 2 
RLBP1	retinaldehyde binding protein 1 
RNASE1	ribonuclease A family member 1, pancreatic 
RNASE2	ribonuclease A family member 2 
RNASE3	ribonuclease A family member 3 
RNASE4	ribonuclease A family member 4 
RND3	Rho family GTPase 3 
RNF8	ring finger protein 8 
RNGTT	RNA guanylyltransferase and 5'-phosphatase 
ROCK1	Rho associated coiled-coil containing protein kinase 1 
ROCK2	Rho associated coiled-coil containing protein kinase 2 
RORA	RAR related orphan receptor A 
RORB	RAR related orphan receptor B 
ROS1	ROS proto-oncogene 1, receptor tyrosine kinase 
RPE	ribulose-5-phosphate-3-epimerase 
RPE65	retinoid isomerohydrolase RPE65 
RPIA	ribose 5-phosphate isomerase A 
RPL10	ribosomal protein L10 
RPL10L	ribosomal protein L10 like 
RPL11	ribosomal protein L11 
RPL13	ribosomal protein L13 
RPL13A	ribosomal protein L13a 
RPL14	ribosomal protein L14 
RPL15	ribosomal protein L15 
RPL18	ribosomal protein L18 
RPL19	ribosomal protein L19 
RPL23	ribosomal protein L23 
RPL23A	ribosomal protein L23a 
RPL26L1	ribosomal protein L26 like 1 
RPL3	ribosomal protein L3 
RPL35	ribosomal protein L35 
RPL37	ribosomal protein L37 
RPL4	ribosomal protein L4 
RPL8	ribosomal protein L8 
RPS13	ribosomal protein S13 
RPS17	ribosomal protein S17 
RPS18	ribosomal protein S18 
RPS19	ribosomal protein S19 
RPS2	ribosomal protein S2 
RPS28	ribosomal protein S28 
RPS5	ribosomal protein S5 
RPS6	ribosomal protein S6 
RPS6KA1	ribosomal protein S6 kinase A1 
RPS6KA3	ribosomal protein S6 kinase A3 
RPS6KA4	ribosomal protein S6 kinase A4 
RPS6KA6	ribosomal protein S6 kinase A6 
RPS8	ribosomal protein S8 
RPS9	ribosomal protein S9 
RPSA	ribosomal protein SA 
RPTOR	regulatory associated protein of MTOR complex 1 
RRAS2	RAS related 2 
RRBP1	ribosome binding protein 1 
RRM1	ribonucleotide reductase catalytic subunit M1 
RRM2	ribonucleotide reductase regulatory subunit M2 
RRM2B	ribonucleotide reductase regulatory TP53 inducible subunit M2B 
RRP7A	ribosomal RNA processing 7 homolog A 
RSL24D1	ribosomal L24 domain containing 1 
RTCB	RNA 2',3'-cyclic phosphate and 5'-OH ligase 
RUVBL2	RuvB like AAA ATPase 2 
RXRA	retinoid X receptor alpha 
RXRB	retinoid X receptor beta 
RXRG	retinoid X receptor gamma 
RYR1	ryanodine receptor 1 
RYR2	ryanodine receptor 2 
RYR3	ryanodine receptor 3 
S100A1	S100 calcium binding protein A1 
S100A10	S100 calcium binding protein A10 
S100A11	S100 calcium binding protein A11 
S100A12	S100 calcium binding protein A12 
S100A13	S100 calcium binding protein A13 
S100A16	S100 calcium binding protein A16 
S100A2	S100 calcium binding protein A2 
S100A4	S100 calcium binding protein A4 
S100A6	S100 calcium binding protein A6 
S100A7	S100 calcium binding protein A7 
S100A8	S100 calcium binding protein A8 
S100A9	S100 calcium binding protein A9 
S100B	S100 calcium binding protein B 
S100G	S100 calcium binding protein G 
S100P	S100 calcium binding protein P 
S1PR1	sphingosine-1-phosphate receptor 1 
S1PR5	sphingosine-1-phosphate receptor 5 
SACM1L	SAC1 like phosphatidylinositide phosphatase 
SAMHD1	SAM and HD domain containing deoxynucleoside triphosphate triphosphohydrolase 1 
SAR1B	secretion associated Ras related GTPase 1B 
SARS1	seryl-tRNA synthetase 1 
SAT1	spermidine/spermine N1-acetyltransferase 1 
SAT2	spermidine/spermine N1-acetyltransferase family member 2 
SBK1	SH3 domain binding kinase 1 
SBK3	SH3 domain binding kinase family member 3 
SCAP	SREBF chaperone 
SCARB1	scavenger receptor class B member 1 
SCGB1A1	secretoglobin family 1A member 1 
SCLY	selenocysteine lyase 
SCMH1	Scm polycomb group protein homolog 1 
SCN10A	sodium voltage-gated channel alpha subunit 10 
SCN11A	sodium voltage-gated channel alpha subunit 11 
SCN1A	sodium voltage-gated channel alpha subunit 1 
SCN1B	sodium voltage-gated channel beta subunit 1 
SCN2A	sodium voltage-gated channel alpha subunit 2 
SCN2B	sodium voltage-gated channel beta subunit 2 
SCN3A	sodium voltage-gated channel alpha subunit 3 
SCN3B	sodium voltage-gated channel beta subunit 3 
SCN4A	sodium voltage-gated channel alpha subunit 4 
SCN4B	sodium voltage-gated channel beta subunit 4 
SCN5A	sodium voltage-gated channel alpha subunit 5 
SCN7A	sodium voltage-gated channel alpha subunit 7 
SCN8A	sodium voltage-gated channel alpha subunit 8 
SCN9A	sodium voltage-gated channel alpha subunit 9 
SCNN1A	sodium channel epithelial 1 alpha subunit 
SCNN1B	sodium channel epithelial 1 beta subunit 
SCNN1D	sodium channel epithelial 1 delta subunit 
SCNN1G	sodium channel epithelial 1 gamma subunit 
SCO1	SCO cytochrome c oxidase assembly protein 1 
SCPEP1	serine carboxypeptidase 1 
SCTR	secretin receptor 
SCYL1	SCY1 like pseudokinase 1 
SDC2	syndecan 2 
SDF2	stromal cell derived factor 2 
SDHA	succinate dehydrogenase complex flavoprotein subunit A 
SDHB	succinate dehydrogenase complex iron sulfur subunit B 
SDHC	succinate dehydrogenase complex subunit C 
SDHD	succinate dehydrogenase complex subunit D 
SDS	serine dehydratase 
SDSL	serine dehydratase like 
SEC14L2	SEC14 like lipid binding 2 
SEC14L3	SEC14 like lipid binding 3 
SEC14L4	SEC14 like lipid binding 4 
SELE	selectin E 
SELENOP	selenoprotein P 
SELP	selectin P 
SEMA3C	semaphorin 3C 
SEMG1	semenogelin 1 
SENP3	SUMO specific peptidase 3 
SEPSECS	Sep (O-phosphoserine) tRNA:Sec (selenocysteine) tRNA synthase 
SERPINA1	serpin family A member 1 
SERPINA3	serpin family A member 3 
SERPINA4	serpin family A member 4 
SERPINA5	serpin family A member 5 
SERPINA6	serpin family A member 6 
SERPINA7	serpin family A member 7 
SERPINB2	serpin family B member 2 
SERPINB3	serpin family B member 3 
SERPINB5	serpin family B member 5 
SERPINB6	serpin family B member 6 
SERPINB9	serpin family B member 9 
SERPINC1	serpin family C member 1 
SERPIND1	serpin family D member 1 
SERPINE1	serpin family E member 1 
SERPINF1	serpin family F member 1 
SERPINF2	serpin family F member 2 
SERPING1	serpin family G member 1 
SETD7	SET domain containing 7, histone lysine methyltransferase 
SF1	splicing factor 1 
SF3A2	splicing factor 3a subunit 2 
SF3A3	splicing factor 3a subunit 3 
SF3B1	splicing factor 3b subunit 1 
SF3B3	splicing factor 3b subunit 3 
SFPQ	splicing factor proline and glutamine rich 
SFRP4	secreted frizzled related protein 4 
SFRP5	secreted frizzled related protein 5 
SFTPA1	surfactant protein A1 
SFTPD	surfactant protein D 
SGK1	serum/glucocorticoid regulated kinase 1 
SGK3	serum/glucocorticoid regulated kinase family member 3 
SGPL1	sphingosine-1-phosphate lyase 1 
SH2B1	SH2B adaptor protein 1 
SH2B3	SH2B adaptor protein 3 
SH2D1A	SH2 domain containing 1A 
SH2D5	SH2 domain containing 5 
SH3BP2	SH3 domain binding protein 2 
SHBG	sex hormone binding globulin 
SHMT1	serine hydroxymethyltransferase 1 
SHMT2	serine hydroxymethyltransferase 2 
SI	sucrase-isomaltase 
SIGLEC1	sialic acid binding Ig like lectin 1 
SIGLEC7	sialic acid binding Ig like lectin 7 
SIGMAR1	sigma non-opioid intracellular receptor 1 
SIK1	salt inducible kinase 1 
SIK2	salt inducible kinase 2 
SIK3	SIK family kinase 3 
SIRT1	sirtuin 1 
SIRT2	sirtuin 2 
SIRT3	sirtuin 3 
SIRT5	sirtuin 5 
SIVA1	SIVA1 apoptosis inducing factor 
SKP1	S-phase kinase associated protein 1 
SLAMF7	SLAM family member 7 
SLC10A1	solute carrier family 10 member 1 
SLC10A2	solute carrier family 10 member 2 
SLC10A6	solute carrier family 10 member 6 
SLC11A2	solute carrier family 11 member 2 
SLC12A1	solute carrier family 12 member 1 
SLC12A2	solute carrier family 12 member 2 
SLC12A3	solute carrier family 12 member 3 
SLC12A4	solute carrier family 12 member 4 
SLC12A5	solute carrier family 12 member 5 
SLC12A6	solute carrier family 12 member 6 
SLC12A7	solute carrier family 12 member 7 
SLC12A8	solute carrier family 12 member 8 
SLC13A1	solute carrier family 13 member 1 
SLC13A2	solute carrier family 13 member 2 
SLC13A3	solute carrier family 13 member 3 
SLC13A5	solute carrier family 13 member 5 
SLC14A1	solute carrier family 14 member 1 (Kidd blood group) 
SLC14A2	solute carrier family 14 member 2 
SLC15A1	solute carrier family 15 member 1 
SLC15A2	solute carrier family 15 member 2 
SLC16A1	solute carrier family 16 member 1 
SLC16A10	solute carrier family 16 member 10 
SLC16A2	solute carrier family 16 member 2 
SLC16A3	solute carrier family 16 member 3 
SLC16A4	solute carrier family 16 member 4 
SLC16A5	solute carrier family 16 member 5 
SLC16A6	solute carrier family 16 member 6 
SLC16A7	solute carrier family 16 member 7 
SLC16A8	solute carrier family 16 member 8 
SLC18A1	solute carrier family 18 member A1 
SLC18A2	solute carrier family 18 member A2 
SLC19A1	solute carrier family 19 member 1 
SLC19A2	solute carrier family 19 member 2 
SLC19A3	solute carrier family 19 member 3 
SLC1A1	solute carrier family 1 member 1 
SLC1A2	solute carrier family 1 member 2 
SLC1A3	solute carrier family 1 member 3 
SLC1A4	solute carrier family 1 member 4 
SLC1A5	solute carrier family 1 member 5 
SLC1A6	solute carrier family 1 member 6 
SLC1A7	solute carrier family 1 member 7 
SLC20A1	solute carrier family 20 member 1 
SLC20A2	solute carrier family 20 member 2 
SLC22A1	solute carrier family 22 member 1 
SLC22A10	solute carrier family 22 member 10 
SLC22A11	solute carrier family 22 member 11 
SLC22A12	solute carrier family 22 member 12 
SLC22A16	solute carrier family 22 member 16 
SLC22A2	solute carrier family 22 member 2 
SLC22A3	solute carrier family 22 member 3 
SLC22A4	solute carrier family 22 member 4 
SLC22A5	solute carrier family 22 member 5 
SLC22A6	solute carrier family 22 member 6 
SLC22A7	solute carrier family 22 member 7 
SLC22A8	solute carrier family 22 member 8 
SLC23A1	solute carrier family 23 member 1 
SLC25A1	solute carrier family 25 member 1 
SLC25A10	solute carrier family 25 member 10 
SLC25A12	solute carrier family 25 member 12 
SLC25A13	solute carrier family 25 member 13 
SLC25A15	solute carrier family 25 member 15 
SLC25A18	solute carrier family 25 member 18 
SLC25A2	solute carrier family 25 member 2 
SLC25A20	solute carrier family 25 member 20 
SLC25A21	solute carrier family 25 member 21 
SLC25A22	solute carrier family 25 member 22 
SLC25A29	solute carrier family 25 member 29 
SLC25A31	solute carrier family 25 member 31 
SLC25A32	solute carrier family 25 member 32 
SLC25A4	solute carrier family 25 member 4 
SLC25A5	solute carrier family 25 member 5 
SLC25A6	solute carrier family 25 member 6 
SLC26A9	solute carrier family 26 member 9 
SLC28A1	solute carrier family 28 member 1 
SLC28A2	solute carrier family 28 member 2 
SLC28A3	solute carrier family 28 member 3 
SLC29A1	solute carrier family 29 member 1 (Augustine blood group) 
SLC29A2	solute carrier family 29 member 2 
SLC29A3	solute carrier family 29 member 3 
SLC29A4	solute carrier family 29 member 4 
SLC2A1	solute carrier family 2 member 1 
SLC2A10	solute carrier family 2 member 10 
SLC2A11	solute carrier family 2 member 11 
SLC2A12	solute carrier family 2 member 12 
SLC2A2	solute carrier family 2 member 2 
SLC2A3	solute carrier family 2 member 3 
SLC2A4	solute carrier family 2 member 4 
SLC2A5	solute carrier family 2 member 5 
SLC2A6	solute carrier family 2 member 6 
SLC2A7	solute carrier family 2 member 7 
SLC2A8	solute carrier family 2 member 8 
SLC2A9	solute carrier family 2 member 9 
SLC30A8	solute carrier family 30 member 8 
SLC30A9	solute carrier family 30 member 9 
SLC31A1	solute carrier family 31 member 1 
SLC31A2	solute carrier family 31 member 2 
SLC32A1	solute carrier family 32 member 1 
SLC34A1	solute carrier family 34 member 1 
SLC34A2	solute carrier family 34 member 2 
SLC34A3	solute carrier family 34 member 3 
SLC36A1	solute carrier family 36 member 1 
SLC36A2	solute carrier family 36 member 2 
SLC38A3	solute carrier family 38 member 3 
SLC39A14	solute carrier family 39 member 14 
SLC3A1	solute carrier family 3 member 1 
SLC41A3	solute carrier family 41 member 3 
SLC44A1	solute carrier family 44 member 1 
SLC44A2	solute carrier family 44 member 2 
SLC44A3	solute carrier family 44 member 3 
SLC44A4	solute carrier family 44 member 4 
SLC46A1	solute carrier family 46 member 1 
SLC47A1	solute carrier family 47 member 1 
SLC47A2	solute carrier family 47 member 2 
SLC4A10	solute carrier family 4 member 10 
SLC4A4	solute carrier family 4 member 4 
SLC4A5	solute carrier family 4 member 5 
SLC4A7	solute carrier family 4 member 7 
SLC4A8	solute carrier family 4 member 8 
SLC51A	solute carrier family 51 alpha subunit 
SLC51B	solute carrier family 51 beta subunit 
SLC52A2	solute carrier family 52 member 2 
SLC5A1	solute carrier family 5 member 1 
SLC5A2	solute carrier family 5 member 2 
SLC5A3	solute carrier family 5 member 3 
SLC5A5	solute carrier family 5 member 5 
SLC5A6	solute carrier family 5 member 6 
SLC5A7	solute carrier family 5 member 7 
SLC5A8	solute carrier family 5 member 8 
SLC6A1	solute carrier family 6 member 1 
SLC6A11	solute carrier family 6 member 11 
SLC6A12	solute carrier family 6 member 12 
SLC6A13	solute carrier family 6 member 13 
SLC6A14	solute carrier family 6 member 14 
SLC6A2	solute carrier family 6 member 2 
SLC6A3	solute carrier family 6 member 3 
SLC6A4	solute carrier family 6 member 4 
SLC6A5	solute carrier family 6 member 5 
SLC6A6	solute carrier family 6 member 6 
SLC6A7	solute carrier family 6 member 7 
SLC6A8	solute carrier family 6 member 8 
SLC6A9	solute carrier family 6 member 9 
SLC7A1	solute carrier family 7 member 1 
SLC7A11	solute carrier family 7 member 11 
SLC7A2	solute carrier family 7 member 2 
SLC7A3	solute carrier family 7 member 3 
SLC7A4	solute carrier family 7 member 4 
SLC7A5	solute carrier family 7 member 5 
SLC7A7	solute carrier family 7 member 7 
SLC7A8	solute carrier family 7 member 8 
SLC7A9	solute carrier family 7 member 9 
SLC8A1	solute carrier family 8 member A1 
SLC9A1	solute carrier family 9 member A1 
SLC9A3	solute carrier family 9 member A3 
SLCO1A2	solute carrier organic anion transporter family member 1A2 
SLCO1B1	solute carrier organic anion transporter family member 1B1 
SLCO1B3	solute carrier organic anion transporter family member 1B3 
SLCO1C1	solute carrier organic anion transporter family member 1C1 
SLCO2A1	solute carrier organic anion transporter family member 2A1 
SLCO2B1	solute carrier organic anion transporter family member 2B1 
SLCO3A1	solute carrier organic anion transporter family member 3A1 
SLCO4A1	solute carrier organic anion transporter family member 4A1 
SLCO4C1	solute carrier organic anion transporter family member 4C1 
SLIT1	slit guidance ligand 1 
SLK	STE20 like kinase 
SMAD2	SMAD family member 2 
SMARCA5	SWI/SNF related, matrix associated, actin dependent regulator of chromatin, subfamily a, member 5 
SMARCE1	SWI/SNF related, matrix associated, actin dependent regulator of chromatin, subfamily e, member 1 
SMG6	SMG6 nonsense mediated mRNA decay factor 
SMN1	survival of motor neuron 1, telomeric 
SMN2	survival of motor neuron 2, centromeric 
SMO	smoothened, frizzled class receptor 
SMOX	spermine oxidase 
SMPD1	sphingomyelin phosphodiesterase 1 
SMPD3	sphingomyelin phosphodiesterase 3 
SMPD4	sphingomyelin phosphodiesterase 4 
SMS	spermine synthase 
SNAP25	synaptosome associated protein 25 
SNCA	synuclein alpha 
SNORD68	small nucleolar RNA, C/D box 68 
SNRK	SNF related kinase 
SNRPA	small nuclear ribonucleoprotein polypeptide A 
SNRPD2	small nuclear ribonucleoprotein D2 polypeptide 
SNU13	small nuclear ribonucleoprotein 13 
SNX3	sorting nexin 3 
SOAT1	sterol O-acyltransferase 1 
SOAT2	sterol O-acyltransferase 2 
SOD1	superoxide dismutase 1 
SOD2	superoxide dismutase 2 
SORCS2	sortilin related VPS10 domain containing receptor 2 
SORD	sorbitol dehydrogenase 
SOST	sclerostin 
SOX10	SRY-box transcription factor 10 
SP1	Sp1 transcription factor 
SPARC	secreted protein acidic and cysteine rich 
SPECC1L	sperm antigen with calponin homology and coiled-coil domains 1 like 
SPG7	SPG7 matrix AAA peptidase subunit, paraplegin 
SPHK1	sphingosine kinase 1 
SPINK6	serine peptidase inhibitor, Kazal type 6 
SPIRE2	spire type actin nucleation factor 2 
SPOPL	speckle type BTB/POZ protein like 
SPP1	secreted phosphoprotein 1 
SPR	sepiapterin reductase 
SPSB2	splA/ryanodine receptor domain and SOCS box containing 2 
SPTBN1	spectrin beta, non-erythrocytic 1 
SPTLC1	serine palmitoyltransferase long chain base subunit 1 
SPTLC2	serine palmitoyltransferase long chain base subunit 2 
SPTLC3	serine palmitoyltransferase long chain base subunit 3 
SQLE	squalene epoxidase 
SRC	SRC proto-oncogene, non-receptor tyrosine kinase 
SRD5A1	steroid 5 alpha-reductase 1 
SRD5A2	steroid 5 alpha-reductase 2 
SRD5A3	steroid 5 alpha-reductase 3 
SREBF1	sterol regulatory element binding transcription factor 1 
SRI	sorcin 
SRM	spermidine synthase 
SRMS	src-related kinase lacking C-terminal regulatory tyrosine and N-terminal myristylation sites 
SRP14	signal recognition particle 14 
SRP19	signal recognition particle 19 
SRPK2	SRSF protein kinase 2 
SRPRB	SRP receptor subunit beta 
SRR	serine racemase 
SRSF1	serine and arginine rich splicing factor 1 
SRSF4	serine and arginine rich splicing factor 4 
SST	somatostatin 
SSTR1	somatostatin receptor 1 
SSTR2	somatostatin receptor 2 
SSTR3	somatostatin receptor 3 
SSTR4	somatostatin receptor 4 
SSTR5	somatostatin receptor 5 
ST13	ST13 Hsp70 interacting protein 
ST14	suppression of tumorigenicity 14 
ST3GAL5	ST3 beta-galactoside alpha-2,3-sialyltransferase 5 
STAB2	stabilin 2 
STAT3	signal transducer and activator of transcription 3 
STAT4	signal transducer and activator of transcription 4 
STAT5B	signal transducer and activator of transcription 5B 
STIP1	stress induced phosphoprotein 1 
STK10	serine/threonine kinase 10 
STK16	serine/threonine kinase 16 
STK17A	serine/threonine kinase 17a 
STK17B	serine/threonine kinase 17b 
STK24	serine/threonine kinase 24 
STK26	serine/threonine kinase 26 
STK3	serine/threonine kinase 3 
STK32A	serine/threonine kinase 32A 
STK33	serine/threonine kinase 33 
STK35	serine/threonine kinase 35 
STK36	serine/threonine kinase 36 
STK38	serine/threonine kinase 38 
STK38L	serine/threonine kinase 38 like 
STK39	serine/threonine kinase 39 
STMN4	stathmin 4 
STS	steroid sulfatase 
STX11	syntaxin 11 
STX1B	syntaxin 1B 
STX4	syntaxin 4 
STXBP2	syntaxin binding protein 2 
SUCLA2	succinate-CoA ligase ADP-forming beta subunit 
SUCLG1	succinate-CoA ligase alpha subunit 
SUCLG2	succinate-CoA ligase GDP-forming beta subunit 
SUCNR1	succinate receptor 1 
SUGCT	succinyl-CoA:glutarate-CoA transferase 
SULT1A1	sulfotransferase family 1A member 1 
SULT1A3	sulfotransferase family 1A member 3 
SULT1A4	sulfotransferase family 1A member 4 
SULT1B1	sulfotransferase family 1B member 1 
SULT1C2	sulfotransferase family 1C member 2 
SULT1C4	sulfotransferase family 1C member 4 
SULT1E1	sulfotransferase family 1E member 1 
SULT2A1	sulfotransferase family 2A member 1 
SULT2B1	sulfotransferase family 2B member 1 
SULT4A1	sulfotransferase family 4A member 1 
SUMO4	small ubiquitin like modifier 4 
SUOX	sulfite oxidase 
SV2A	synaptic vesicle glycoprotein 2A 
SV2C	synaptic vesicle glycoprotein 2C 
SYK	spleen associated tyrosine kinase 
SYN1	synapsin I 
SYT2	synaptotagmin 2 
SYTL4	synaptotagmin like 4 
TAAR1	trace amine associated receptor 1 
TAAR6	trace amine associated receptor 6 
TAB1	TGF-beta activated kinase 1 (MAP3K7) binding protein 1 
TAC3	tachykinin precursor 3 
TACR1	tachykinin receptor 1 
TACR2	tachykinin receptor 2 
TACR3	tachykinin receptor 3 
TAGLN	transgelin 
TAGLN2	transgelin 2 
TANC1	tetratricopeptide repeat, ankyrin repeat and coiled-coil containing 1 
TANC2	tetratricopeptide repeat, ankyrin repeat and coiled-coil containing 2 
TAOK1	TAO kinase 1 
TAOK2	TAO kinase 2 
TAOK3	TAO kinase 3 
TAP1	transporter 1, ATP binding cassette subfamily B member 
TAPBP	TAP binding protein 
TARS1	threonyl-tRNA synthetase 1 
TARS2	threonyl-tRNA synthetase 2, mitochondrial 
TAS1R2	taste 1 receptor member 2 
TAS1R3	taste 1 receptor member 3 
TAS2R16	taste 2 receptor member 16 
TAT	tyrosine aminotransferase 
TBC1D1	TBC1 domain family member 1 
TBC1D32	TBC1 domain family member 32 
TBK1	TANK binding kinase 1 
TBL1XR1	transducin beta like 1 X-linked receptor 1 
TBX21	T-box transcription factor 21 
TBXA2R	thromboxane A2 receptor 
TBXAS1	thromboxane A synthase 1 
TBXT	T-box transcription factor T 
TCF19	transcription factor 19 
TCF7L2	transcription factor 7 like 2 
TCL1A	T cell leukemia/lymphoma 1A 
TCN1	transcobalamin 1 
TCN2	transcobalamin 2 
TDO2	tryptophan 2,3-dioxygenase 
TEC	tec protein tyrosine kinase 
TEK	TEK receptor tyrosine kinase 
TENT4A	terminal nucleotidyltransferase 4A 
TERT	telomerase reverse transcriptase 
TESK1	testis associated actin remodelling kinase 1 
TESMIN	testis expressed metallothionein like protein 
TET2	tet methylcytosine dioxygenase 2 
TEX10	testis expressed 10 
TF	transferrin 
TFF1	trefoil factor 1 
TFF2	trefoil factor 2 
TFPI	tissue factor pathway inhibitor 
TFR2	transferrin receptor 2 
TFRC	transferrin receptor 
TGFB1	transforming growth factor beta 1 
TGFB2	transforming growth factor beta 2 
TGFB3	transforming growth factor beta 3 
TGFBI	transforming growth factor beta induced 
TGFBR1	transforming growth factor beta receptor 1 
TGFBR2	transforming growth factor beta receptor 2 
TGFBR3	transforming growth factor beta receptor 3 
TGM1	transglutaminase 1 
TGM2	transglutaminase 2 
TGM3	transglutaminase 3 
TGM4	transglutaminase 4 
TGM5	transglutaminase 5 
TGM6	transglutaminase 6 
TGM7	transglutaminase 7 
TH	tyrosine hydroxylase 
THBD	thrombomodulin 
THNSL1	threonine synthase like 1 
THRA	thyroid hormone receptor alpha 
THRB	thyroid hormone receptor beta 
TIE1	tyrosine kinase with immunoglobulin like and EGF like domains 1 
TIMP3	TIMP metallopeptidase inhibitor 3 
TIRAP	TIR domain containing adaptor protein 
TJP1	tight junction protein 1 
TK1	thymidine kinase 1 
TK2	thymidine kinase 2 
TKT	transketolase 
TLK1	tousled like kinase 1 
TLK2	tousled like kinase 2 
TLL2	tolloid like 2 
TLR2	toll like receptor 2 
TLR3	toll like receptor 3 
TLR4	toll like receptor 4 
TLR5	toll like receptor 5 
TLR7	toll like receptor 7 
TLR8	toll like receptor 8 
TLR9	toll like receptor 9 
TMEM167A	transmembrane protein 167A 
TMLHE	trimethyllysine hydroxylase, epsilon 
TNF	tumor necrosis factor 
TNFAIP3	TNF alpha induced protein 3 
TNFAIP6	TNF alpha induced protein 6 
TNFRSF10A	TNF receptor superfamily member 10a 
TNFRSF10B	TNF receptor superfamily member 10b 
TNFRSF11A	TNF receptor superfamily member 11a 
TNFRSF11B	TNF receptor superfamily member 11b 
TNFRSF1A	TNF receptor superfamily member 1A 
TNFRSF1B	TNF receptor superfamily member 1B 
TNFRSF8	TNF receptor superfamily member 8 
TNFRSF9	TNF receptor superfamily member 9 
TNFSF11	TNF superfamily member 11 
TNFSF13B	TNF superfamily member 13b 
TNIK	TRAF2 and NCK interacting kinase 
TNK1	tyrosine kinase non receptor 1 
TNK2	tyrosine kinase non receptor 2 
TNNC1	troponin C1, slow skeletal and cardiac type 
TNNC2	troponin C2, fast skeletal type 
TNNI3	troponin I3, cardiac type 
TNNI3K	TNNI3 interacting kinase 
TOLLIP	toll interacting protein 
TOMM40	translocase of outer mitochondrial membrane 40 
TOP1	DNA topoisomerase I 
TOP1MT	DNA topoisomerase I mitochondrial 
TOP2A	DNA topoisomerase II alpha 
TOP2B	DNA topoisomerase II beta 
TP53	tumor protein p53 
TP53AIP1	tumor protein p53 regulated apoptosis inducing protein 1 
TP73	tumor protein p73 
TPD52L2	TPD52 like 2 
TPH1	tryptophan hydroxylase 1 
TPH2	tryptophan hydroxylase 2 
TPI1	triosephosphate isomerase 1 
TPK1	thiamin pyrophosphokinase 1 
TPM1	tropomyosin 1 
TPM3	tropomyosin 3 
TPM4	tropomyosin 4 
TPMT	thiopurine S-methyltransferase 
TPO	thyroid peroxidase 
TPP1	tripeptidyl peptidase 1 
TPSAB1	tryptase alpha/beta 1 
TPSB2	tryptase beta 2 (gene/pseudogene) 
TPT1	tumor protein, translationally-controlled 1 
TRAC	T cell receptor alpha constant 
TRAF1	TNF receptor associated factor 1 
TRAF3IP2	TRAF3 interacting protein 2 
TRAPPC1	trafficking protein particle complex 1 
TRAPPC3	trafficking protein particle complex 3 
TRAPPC4	trafficking protein particle complex 4 
TRAPPC5	trafficking protein particle complex 5 
TRAPPC6A	trafficking protein particle complex 6A 
TRAPPC6B	trafficking protein particle complex 6B 
TRBC1	T cell receptor beta constant 1 
TRDMT1	tRNA aspartic acid methyltransferase 1 
TREM1	triggering receptor expressed on myeloid cells 1 
TREML4	triggering receptor expressed on myeloid cells like 4 
TRHR	thyrotropin releasing hormone receptor 
TRIB2	tribbles pseudokinase 2 
TRIB3	tribbles pseudokinase 3 
TRIM13	tripartite motif containing 13 
TRPA1	transient receptor potential cation channel subfamily A member 1 
TRPM4	transient receptor potential cation channel subfamily M member 4 
TRPM6	transient receptor potential cation channel subfamily M member 6 
TRPM7	transient receptor potential cation channel subfamily M member 7 
TRPM8	transient receptor potential cation channel subfamily M member 8 
TRPV1	transient receptor potential cation channel subfamily V member 1 
TRPV2	transient receptor potential cation channel subfamily V member 2 
TRPV3	transient receptor potential cation channel subfamily V member 3 
TRPV4	transient receptor potential cation channel subfamily V member 4 
TRPV5	transient receptor potential cation channel subfamily V member 5 
TRPV6	transient receptor potential cation channel subfamily V member 6 
TSC1	TSC complex subunit 1 
TSHR	thyroid stimulating hormone receptor 
TSPAN5	tetraspanin 5 
TSPO	translocator protein 
TSPYL1	TSPY like 1 
TSSK1B	testis specific serine kinase 1B 
TST	thiosulfate sulfurtransferase 
TSTA3	tissue specific transplantation antigen P35B 
TTC37	tetratricopeptide repeat domain 37 
TTK	TTK protein kinase 
TTLL3	tubulin tyrosine ligase like 3 
TTPA	alpha tocopherol transfer protein 
TTR	transthyretin 
TUB	TUB bipartite transcription factor 
TUBA1A	tubulin alpha 1a 
TUBA1B	tubulin alpha 1b 
TUBA1C	tubulin alpha 1c 
TUBA3C	tubulin alpha 3c 
TUBA3E	tubulin alpha 3e 
TUBA4A	tubulin alpha 4a 
TUBA4B	tubulin alpha 4b 
TUBA8	tubulin alpha 8 
TUBB	tubulin beta class I 
TUBB1	tubulin beta 1 class VI 
TUBB2A	tubulin beta 2A class IIa 
TUBB2B	tubulin beta 2B class IIb 
TUBB3	tubulin beta 3 class III 
TUBB4A	tubulin beta 4A class IVa 
TUBB4B	tubulin beta 4B class IVb 
TUBB6	tubulin beta 6 class V 
TUBD1	tubulin delta 1 
TUBE1	tubulin epsilon 1 
TUBG1	tubulin gamma 1 
TUFM	Tu translation elongation factor, mitochondrial 
TXK	TXK tyrosine kinase 
TXN	thioredoxin 
TXNDC11	thioredoxin domain containing 11 
TXNDC12	thioredoxin domain containing 12 
TXNRD1	thioredoxin reductase 1 
TXNRD2	thioredoxin reductase 2 
TYK2	tyrosine kinase 2 
TYMP	thymidine phosphorylase 
TYMS	thymidylate synthetase 
TYMSOS	TYMS opposite strand 
TYR	tyrosinase 
TYRO3	TYRO3 protein tyrosine kinase 
UAP1	UDP-N-acetylglucosamine pyrophosphorylase 1 
UBA1	ubiquitin like modifier activating enzyme 1 
UBB	ubiquitin B 
UBC	ubiquitin C 
UBE2D2	ubiquitin conjugating enzyme E2 D2 
UBE2I	ubiquitin conjugating enzyme E2 I 
UBR4	ubiquitin protein ligase E3 component n-recognin 4 
UCHL1	ubiquitin C-terminal hydrolase L1 
UCK2	uridine-cytidine kinase 2 
UCKL1	uridine-cytidine kinase 1 like 1 
UGCG	UDP-glucose ceramide glucosyltransferase 
UGDH	UDP-glucose 6-dehydrogenase 
UGGT2	UDP-glucose glycoprotein glucosyltransferase 2 
UGT1A	UDP glucuronosyltransferase family 1 member A complex locus
UGT1A1	UDP glucuronosyltransferase family 1 member A1 
UGT1A10	UDP glucuronosyltransferase family 1 member A10 
UGT1A3	UDP glucuronosyltransferase family 1 member A3 
UGT1A4	UDP glucuronosyltransferase family 1 member A4 
UGT1A5	UDP glucuronosyltransferase family 1 member A5 
UGT1A6	UDP glucuronosyltransferase family 1 member A6 
UGT1A7	UDP glucuronosyltransferase family 1 member A7 
UGT1A8	UDP glucuronosyltransferase family 1 member A8 
UGT1A9	UDP glucuronosyltransferase family 1 member A9 
UGT2A1	UDP glucuronosyltransferase family 2 member A1 complex locus 
UGT2B10	UDP glucuronosyltransferase family 2 member B10 
UGT2B11	UDP glucuronosyltransferase family 2 member B11 
UGT2B15	UDP glucuronosyltransferase family 2 member B15 
UGT2B17	UDP glucuronosyltransferase family 2 member B17 
UGT2B4	UDP glucuronosyltransferase family 2 member B4 
UGT2B7	UDP glucuronosyltransferase family 2 member B7 
UGT3A1	UDP glycosyltransferase family 3 member A1 
UGT8	UDP glycosyltransferase 8 
ULK1	unc-51 like autophagy activating kinase 1 
ULK2	unc-51 like autophagy activating kinase 2 
ULK3	unc-51 like kinase 3
UMPS	uridine monophosphate synthetase 
UNC13D	unc-13 homolog D 
UNG	uracil DNA glycosylase 
UPP1	uridine phosphorylase 1 
UPP2	uridine phosphorylase 2 
UQCR10	ubiquinol-cytochrome c reductase, complex III subunit X 
UQCR11	ubiquinol-cytochrome c reductase, complex III subunit XI 
UQCRB	ubiquinol-cytochrome c reductase binding protein 
UQCRC1	ubiquinol-cytochrome c reductase core protein 1 
UQCRC2	ubiquinol-cytochrome c reductase core protein 2 
UQCRFS1	ubiquinol-cytochrome c reductase, Rieske iron-sulfur polypeptide 1 
UQCRH	ubiquinol-cytochrome c reductase hinge protein 
UQCRQ	ubiquinol-cytochrome c reductase complex III subunit VII 
UROD	uroporphyrinogen decarboxylase 
USP14	ubiquitin specific peptidase 14 
UST	uronyl 2-sulfotransferase 
UTRN	utrophin 
VAC14	VAC14 component of PIKFYVE complex 
VAMP1	vesicle associated membrane protein 1 
VAMP2	vesicle associated membrane protein 2 
VARS1	valyl-tRNA synthetase 1 
VASP	vasodilator stimulated phosphoprotein 
VCAM1	vascular cell adhesion molecule 1 
VCAN	versican 
VCP	valosin containing protein 
VDAC1	voltage dependent anion channel 1 
VDAC2	voltage dependent anion channel 2 
VDAC3	voltage dependent anion channel 3 
VDR	vitamin D receptor 
VEGFA	vascular endothelial growth factor A 
VEGFB	vascular endothelial growth factor B 
VIM	vimentin 
VKORC1	vitamin K epoxide reductase complex subunit 1 
VKORC1L1	vitamin K epoxide reductase complex subunit 1 like 1 
VLDLR	very low density lipoprotein receptor 
VTN	vitronectin 
VWF	von Willebrand factor 
WARS1	tryptophanyl-tRNA synthetase 1 
WARS2	tryptophanyl tRNA synthetase 2, mitochondrial 
WAS	WASP actin nucleation promoting factor 
WEE1	WEE1 G2 checkpoint kinase 
WIF1	WNT inhibitory factor 1 
WNK1	WNK lysine deficient protein kinase 1 
WNT5B	Wnt family member 5B 
XBP1	X-box binding protein 1 
XDH	xanthine dehydrogenase 
XIAP	X-linked inhibitor of apoptosis 
XIRP2	xin actin binding repeat containing 2 
XPA	XPA, DNA damage recognition and repair factor 
XPC	XPC complex subunit, DNA damage recognition and repair factor 
XPO1	exportin 1 
XRCC1	X-ray repair cross complementing 1 
XRCC3	X-ray repair cross complementing 3 
XRCC4	X-ray repair cross complementing 4 
XRCC5	X-ray repair cross complementing 5 
YARS1	tyrosyl-tRNA synthetase 1 
YARS2	tyrosyl-tRNA synthetase 2 
YEATS4	YEATS domain containing 4 
YES1	YES proto-oncogene 1, Src family tyrosine kinase 
YWHAB	tyrosine 3-monooxygenase/tryptophan 5-monooxygenase activation protein beta 
YWHAE	tyrosine 3-monooxygenase/tryptophan 5-monooxygenase activation protein epsilon 
YWHAH	tyrosine 3-monooxygenase/tryptophan 5-monooxygenase activation protein eta 
YWHAQ	tyrosine 3-monooxygenase/tryptophan 5-monooxygenase activation protein theta 
YWHAZ	tyrosine 3-monooxygenase/tryptophan 5-monooxygenase activation protein zeta 
ZAP70	zeta chain of T cell receptor associated protein kinase 70 
ZBTB22	zinc finger and BTB domain containing 22 
ZDHHC7	zinc finger DHHC-type containing 7 
ZFY	zinc finger protein Y-linked 
ZMAT4	zinc finger matrin-type 4 
ZNF134	zinc finger protein 134 
ZNF211	zinc finger protein 211 
ZNF385D	zinc finger protein 385D 
ZNF423	zinc finger protein 423 
ZNF565	zinc finger protein 565 
ZNF697	zinc finger protein 697 
ZNF804A	zinc finger protein 804A 
ZNF816	zinc finger protein 816 
ZSCAN25	zinc finger and SCAN domain containing 25 
ZYX	zyxin 
